iterCounter, dimersInMT, activeDimersInMT, inactiveDimersInMT, activeDimersFree,inactiveDimersFree, longestProtoFilament, lengthOfMT, totalGTPs, activeGTPs,inactiveGTPs, mtRepresentation, DeHydro Katanins, Hydro Katanins, Bonded Katanins

21,0,0,0,0,600,0,0,600,0,600,XXXXXXXXXXXXXXXXXXXXXXXXXXXXXXXXXXXXXXXXXXXXXXXXXXXXXXXXXXXXXXXXXXXXXXXXXXXXXXXXXXXXXXXXXXXXXXXXXXXXXXXXXXXXXXXXXXXXXXXXXXXXXXXXXXXXXXXXXXXXXXXXXXXXXXXXXXXXXXXXXXXXXXXXXXXXXXXXXXXXXXXXXXXXXXXXXXXXXXXXXXXXXXXXXXXXXXXXXXXXXXXXXXXXXXXXXXXXXXXXXXXXXXXXXXXXXXXXXXXXXXXXXXXXXXXXXXXXXXXXXXXXXX,0,0,0
42,0,0,0,0,600,0,0,600,0,600,XXXXXXXXXXXXXXXXXXXXXXXXXXXXXXXXXXXXXXXXXXXXXXXXXXXXXXXXXXXXXXXXXXXXXXXXXXXXXXXXXXXXXXXXXXXXXXXXXXXXXXXXXXXXXXXXXXXXXXXXXXXXXXXXXXXXXXXXXXXXXXXXXXXXXXXXXXXXXXXXXXXXXXXXXXXXXXXXXXXXXXXXXXXXXXXXXXXXXXXXXXXXXXXXXXXXXXXXXXXXXXXXXXXXXXXXXXXXXXXXXXXXXXXXXXXXXXXXXXXXXXXXXXXXXXXXXXXXXXXXXXXXXX,0,0,0
63,0,0,0,0,600,0,0,600,0,600,XXXXXXXXXXXXXXXXXXXXXXXXXXXXXXXXXXXXXXXXXXXXXXXXXXXXXXXXXXXXXXXXXXXXXXXXXXXXXXXXXXXXXXXXXXXXXXXXXXXXXXXXXXXXXXXXXXXXXXXXXXXXXXXXXXXXXXXXXXXXXXXXXXXXXXXXXXXXXXXXXXXXXXXXXXXXXXXXXXXXXXXXXXXXXXXXXXXXXXXXXXXXXXXXXXXXXXXXXXXXXXXXXXXXXXXXXXXXXXXXXXXXXXXXXXXXXXXXXXXXXXXXXXXXXXXXXXXXXXXXXXXXXX,0,0,0
84,0,0,0,0,600,0,0,600,0,600,XXXXXXXXXXXXXXXXXXXXXXXXXXXXXXXXXXXXXXXXXXXXXXXXXXXXXXXXXXXXXXXXXXXXXXXXXXXXXXXXXXXXXXXXXXXXXXXXXXXXXXXXXXXXXXXXXXXXXXXXXXXXXXXXXXXXXXXXXXXXXXXXXXXXXXXXXXXXXXXXXXXXXXXXXXXXXXXXXXXXXXXXXXXXXXXXXXXXXXXXXXXXXXXXXXXXXXXXXXXXXXXXXXXXXXXXXXXXXXXXXXXXXXXXXXXXXXXXXXXXXXXXXXXXXXXXXXXXXXXXXXXXXX,0,0,0

105,0,0,0,0,600,0,0,600,0,600,XXXXXXXXXXXXXXXXXXXXXXXXXXXXXXXXXXXXXXXXXXXXXXXXXXXXXXXXXXXXXXXXXXXXXXXXXXXXXXXXXXXXXXXXXXXXXXXXXXXXXXXXXXXXXXXXXXXXXXXXXXXXXXXXXXXXXXXXXXXXXXXXXXXXXXXXXXXXXXXXXXXXXXXXXXXXXXXXXXXXXXXXXXXXXXXXXXXXXXXXXXXXXXXXXXXXXXXXXXXXXXXXXXXXXXXXXXXXXXXXXXXXXXXXXXXXXXXXXXXXXXXXXXXXXXXXXXXXXXXXXXXXXX,0,0,0
126,0,0,0,0,600,0,0,600,0,600,XXXXXXXXXXXXXXXXXXXXXXXXXXXXXXXXXXXXXXXXXXXXXXXXXXXXXXXXXXXXXXXXXXXXXXXXXXXXXXXXXXXXXXXXXXXXXXXXXXXXXXXXXXXXXXXXXXXXXXXXXXXXXXXXXXXXXXXXXXXXXXXXXXXXXXXXXXXXXXXXXXXXXXXXXXXXXXXXXXXXXXXXXXXXXXXXXXXXXXXXXXXXXXXXXXXXXXXXXXXXXXXXXXXXXXXXXXXXXXXXXXXXXXXXXXXXXXXXXXXXXXXXXXXXXXXXXXXXXXXXXXXXXX,0,0,0
147,0,0,0,0,600,0,0,600,0,600,XXXXXXXXXXXXXXXXXXXXXXXXXXXXXXXXXXXXXXXXXXXXXXXXXXXXXXXXXXXXXXXXXXXXXXXXXXXXXXXXXXXXXXXXXXXXXXXXXXXXXXXXXXXXXXXXXXXXXXXXXXXXXXXXXXXXXXXXXXXXXXXXXXXXXXXXXXXXXXXXXXXXXXXXXXXXXXXXXXXXXXXXXXXXXXXXXXXXXXXXXXXXXXXXXXXXXXXXXXXXXXXXXXXXXXXXXXXXXXXXXXXXXXXXXXXXXXXXXXXXXXXXXXXXXXXXXXXXXXXXXXXXXX,0,0,0
168,0,0,0,0,600,0,0,600,0,600,XXXXXXXXXXXXXXXXXXXXXXXXXXXXXXXXXXXXXXXXXXXXXXXXXXXXXXXXXXXXXXXXXXXXXXXXXXXXXXXXXXXXXXXXXXXXXXXXXXXXXXXXXXXXXXXXXXXXXXXXXXXXXXXXXXXXXXXXXXXXXXXXXXXXXXXXXXXXXXXXXXXXXXXXXXXXXXXXXXXXXXXXXXXXXXXXXXXXXXXXXXXXXXXXXXXXXXXXXXXXXXXXXXXXXXXXXXXXXXXXXXXXXXXXXXXXXXXXXXXXXXXXXXXXXXXXXXXXXXXXXXXXXX,0,0,0
189,0,0,0,0,600,0,0,600,0,600,XXXXXXXXXXXXXXXXXXXXXXXXXXXXXXXXXXXXXXXXXXXXXXXXXXXXXXXXXXXXXXXXXXXXXXXXXXXXXXXXXXXXXXXXXXXXXXXXXXXXXXXXXXXXXXXXXXXXXXXXXXXXXXXXXXXXXXXXXXXXXXXXXXXXXXXXXXXXXXXXXXXXXXXXXXXXXXXXXXXXXXXXXXXXXXXXXXXXXXXXXXXXXXXXXXXXXXXXXXXXXXXXXXXXXXXXXXXXXXXXXXXXXXXXXXXXXXXXXXXXXXXXXXXXXXXXXXXXXXXXXXXXXX,0,0,0

210,0,0,0,1,599,0,0,599,13,586,XXXXXXXXXXXXXXXXXXXXXXXXXXXXXXXXXXXXXXXXXXXXXXXXXXXXXXXXXXXXXXXXXXXXXXXXXXXXXXXXXXXXXXXXXXXXXXXXXXXXXXXXXXXXXXXXXXXXXXXXXXXXXXXXXXXXXXXXXXXXXXXXXXXXXXXXXXXXXXXXXXXXXXXXXXXXXXXXXXXXXXXXXXXXXXXXXXXXXXXXXXXXXXXXXXXXXXXXXXXXXXXXXXXXXXXXXXXXXXXXXXXXXXXXXXXXXXXXXXXXXXXXXXXXXXXXXXXXXXXXXXXXXX,0,0,0
231,0,0,0,4,596,0,0,596,55,541,XXXXXXXXXXXXXXXXXXXXXXXXXXXXXXXXXXXXXXXXXXXXXXXXXXXXXXXXXXXXXXXXXXXXXXXXXXXXXXXXXXXXXXXXXXXXXXXXXXXXXXXXXXXXXXXXXXXXXXXXXXXXXXXXXXXXXXXXXXXXXXXXXXXXXXXXXXXXXXXXXXXXXXXXXXXXXXXXXXXXXXXXXXXXXXXXXXXXXXXXXXXXXXXXXXXXXXXXXXXXXXXXXXXXXXXXXXXXXXXXXXXXXXXXXXXXXXXXXXXXXXXXXXXXXXXXXXXXXXXXXXXXXX,0,0,0
252,0,0,0,13,587,0,0,587,94,493,XXXXXXXXXXXXXXXXXXXXXXXXXXXXXXXXXXXXXXXXXXXXXXXXXXXXXXXXXXXXXXXXXXXXXXXXXXXXXXXXXXXXXXXXXXXXXXXXXXXXXXXXXXXXXXXXXXXXXXXXXXXXXXXXXXXXXXXXXXXXXXXXXXXXXXXXXXXXXXXXXXXXXXXXXXXXXXXXXXXXXXXXXXXXXXXXXXXXXXXXXXXXXXXXXXXXXXXXXXXXXXXXXXXXXXXXXXXXXXXXXXXXXXXXXXXXXXXXXXXXXXXXXXXXXXXXXXXXXXXXXXXXXX,0,0,0
273,0,0,0,21,579,0,0,579,130,449,XXXXXXXXXXXXXXXXXXXXXXXXXXXXXXXXXXXXXXXXXXXXXXXXXXXXXXXXXXXXXXXXXXXXXXXXXXXXXXXXXXXXXXXXXXXXXXXXXXXXXXXXXXXXXXXXXXXXXXXXXXXXXXXXXXXXXXXXXXXXXXXXXXXXXXXXXXXXXXXXXXXXXXXXXXXXXXXXXXXXXXXXXXXXXXXXXXXXXXXXXXXXXXXXXXXXXXXXXXXXXXXXXXXXXXXXXXXXXXXXXXXXXXXXXXXXXXXXXXXXXXXXXXXXXXXXXXXXXXXXXXXXXX,0,0,0
294,0,0,0,33,567,0,0,567,168,399,XXXXXXXXXXXXXXXXXXXXXXXXXXXXXXXXXXXXXXXXXXXXXXXXXXXXXXXXXXXXXXXXXXXXXXXXXXXXXXXXXXXXXXXXXXXXXXXXXXXXXXXXXXXXXXXXXXXXXXXXXXXXXXXXXXXXXXXXXXXXXXXXXXXXXXXXXXXXXXXXXXXXXXXXXXXXXXXXXXXXXXXXXXXXXXXXXXXXXXXXXXXXXXXXXXXXXXXXXXXXXXXXXXXXXXXXXXXXXXXXXXXXXXXXXXXXXXXXXXXXXXXXXXXXXXXXXXXXXXXXXXXXXX,0,0,0

315,0,0,0,51,549,0,0,549,203,346,XXXXXXXXXXXXXXXXXXXXXXXXXXXXXXXXXXXXXXXXXXXXXXXXXXXXXXXXXXXXXXXXXXXXXXXXXXXXXXXXXXXXXXXXXXXXXXXXXXXXXXXXXXXXXXXXXXXXXXXXXXXXXXXXXXXXXXXXXXXXXXXXXXXXXXXXXXXXXXXXXXXXXXXXXXXXXXXXXXXXXXXXXXXXXXXXXXXXXXXXXXXXXXXXXXXXXXXXXXXXXXXXXXXXXXXXXXXXXXXXXXXXXXXXXXXXXXXXXXXXXXXXXXXXXXXXXXXXXXXXXXXXXX,0,0,0
336,1,1,0,60,539,0,0,539,221,318,XXXXXXXXXXXXXXXXXXXXXXXXXXXXXXXXXXXXXXXXXXXXGXXXXXXXXXXXXXXXXXXXXXXXXXXXXXXXXXXXXXXXXXXXXXXXXXXXXXXXXXXXXXXXXXXXXXXXXXXXXXXXXXXXXXXXXXXXXXXXXXXXXXXXXXXXXXXXXXXXXXXXXXXXXXXXXXXXXXXXXXXXXXXXXXXXXXXXXXXXXXXXXXXXXXXXXXXXXXXXXXXXXXXXXXXXXXXXXXXXXXXXXXXXXXXXXXXXXXXXXXXXXXXXXXXXXXXXXXXXXXXXXX,0,0,0
357,1,1,0,77,522,0,0,522,252,270,XXXXXXXXXXXXXXXXXXXXXXXXXXXXXXXXXXXXXXXXXXXXGXXXXXXXXXXXXXXXXXXXXXXXXXXXXXXXXXXXXXXXXXXXXXXXXXXXXXXXXXXXXXXXXXXXXXXXXXXXXXXXXXXXXXXXXXXXXXXXXXXXXXXXXXXXXXXXXXXXXXXXXXXXXXXXXXXXXXXXXXXXXXXXXXXXXXXXXXXXXXXXXXXXXXXXXXXXXXXXXXXXXXXXXXXXXXXXXXXXXXXXXXXXXXXXXXXXXXXXXXXXXXXXXXXXXXXXXXXXXXXXXX,0,0,0
378,5,5,0,90,505,0,0,505,270,235,XXXXXXXXXXXXXXXXXXXXXXXXXXXXXXXXXXXXXXXXXXXXGXXXXXXXXXXXXXXXXXXXXXXXXXXXXXXXXXXXXXXXXXXXXXXXXXXXXXXXXXXXXXXXXXXXXXXXXXXXXXXXXXXXXXXXXXXXXXXXXXXXXXXXXXXXXXXXXXXXXXXXXXXXXXXXXXXXGAAAXXXXXXXXXXXXXXXXXXXXXXXXXXXXXXXXXXXXXXXXXXXXXXXXXXXXXXXXXXXXXXXXXXXXXXXXXXXXXXXXXXXXXXXXXXXXXXXXXXXXXXXXXX,0,0,0
399,8,8,0,103,489,0,0,489,293,196,XXXXXXXXXXXXXXXXXXXXXXXXXXXXXXXXXXXXXXXXXXXXGAXXXXXXXXXXXXXXXXXXXXXXXXXXXXXXXXXXXXXXXXXXXXXXXXXXXXXXXXXXXXXXXXXXXXXXXXXXXXXXXXXXXXXXXXXXXXXXXXXXXXXXXXXXXXXXXXXXXXXXXXXXXXXXXXXXGAAAAAXXXXXXXXXXXXXXXXXXXXXXXXXXXXXXXXXXXXXXXXXXXXXXXXXXXXXXXXXXXXXXXXXXXXXXXXXXXXXXXXXXXXXXXXXXXXXXXXXXXXXXXX,0,0,0

420,12,12,0,118,470,0,0,470,310,160,XXXXXXXXXXXXXXXXXXXXXXXXXXXXXXXXXXXXXXXXXXXXGAXXXXXXXXXXXXXXXXXXXXXXXXXXXXXXXXXXXXXXXXXXXXXXXXXXXXXXXXXXXXXXXXXXXXXXXXXXXXXXXXXXXXXXXXXXXXXXXXXXXXXXXXXXXXXXXXXXXXXXXXXXXXXXXXXXGAAAAAAAAAXXXXXXXXXXXXXXXXXXXXXXXXXXXXXXXXXXXXXXXXXXXXXXXXXXXXXXXXXXXXXXXXXXXXXXXXXXXXXXXXXXXXXXXXXXXXXXXXXXXX,0,0,0
441,20,20,0,133,447,0,0,447,338,109,XXXXXXXXXXXXXXXXXXXXXXGAXXXXXXXXXXXXXXXXXXXXGAXXXXXXXXXXXXXXXXXXXXXXXXXXXXXXXXXXXXXXXXXXXXXXXXXXXXXXXXXXXXXXXXXXXXXXXXXXXXXXXXXXXXXXXXXXXXXXXXXXXXXXXXXXXXGXXXXXXXXXXXXXXXXXXXXXGAAAAAAAAAAXXXXXXXXXXXXXXXXXXXXXXXXXXXXXXXXXXXXXXXXXXXXXXXXXXXXXXXGAAAXXXXXXXXXXXXXXXXXXXXXXXXXXXXXXXXXXXXXXXX,0,0,0
462,21,21,0,153,426,0,0,426,350,76,XXXXXXXXXXXXXXXXXXXXXXGAXXXXXXXXXXXXXXXXXXXXGAXXXXXXXXXXXXXXXXXXXXXXXXXXXXXXXXXXXXXXXXXXXXXXXXXXXXXXXXXXXXXXXXXXXXXXXXXXXXXXXXXXXXXXXXXXXXXXXXXXXXXXXXXXXXGXXXXXXXXXXXXXXXXXXXXXGAAAAAAAAAAXXXXXXXXXXXXXXXXXXXXXXXXXXXXXXXXXXXXXXXXXXXXXXXXXXXXXXXGAAAAXXXXXXXXXXXXXXXXXXXXXXXXXXXXXXXXXXXXXXX,0,0,0
483,26,25,1,162,412,0,0,413,375,38,XXXXXXXXXXXXXXXXXXXXXXGAAAAAXXXXXXXXXXXXXXXXGAXXXXXXXXXXXXXXXXXXXXXXXXXXXXXXXXXXXXXXXXXXXXXXXXXXXXXXXXXXXXXXXXXXXXXXXXXXXXXXXXXXXXXXGXXXXXXXXXXXXXXXXXXXXXGXXXXXXXXXXXXXXXXXXXXXGAAAAOAAAAAXXXXXXXXXXXXXXXXXXXXXXXXXXXXXXXXXXXXXXXXXXXXXXXXXXXXXXXGAAAAXXXXXXXXXXXXXXXXXXXXXXXXXXXXXXXXXXXXXXX,0,0,0
504,29,28,1,172,399,0,0,400,397,3,XXXXXXXXXXXXXXXXXXXXXXGAAAAAAXXXXXXXXXXXXXXXGAXXXXXXXXXXXXXXXXXXXXGXXXXXXXXXXXXXXXXXXXXXXXXXXXXXXXXXXXXXXXXXXXXXXXXXXXXXXXXXXXXXXXXXGXXXXXXXXXXXXXXXXXXXXXGXXXXXXXXXXXXXXXXXXXXXGAAAAOAAAAAXXXXXXXXXXXXXXXXXXXXXXXXXXXXXXXXXGXXXXXXXXXXXXXXXXXXXXXGAAAAXXXXXXXXXXXXXXXXXXXXXXXXXXXXXXXXXXXXXXX,0,0,0

525,31,28,3,181,388,0,0,391,386,5,XXXXXXXXXXXXXXXXXXXXXXGAAAOAAAXXXXXXXXXXXXXXGAXXXXXXXXXXXXXXXXXXXXGXXXXXXXXXXXXXXXXXXXXXXXXXXXXXXXXXXXXXXXXXXXXXXXXXXXXXXXXXXXXXXXXXGXXXXXXXXXXXXXXXXXXXXXGXXXXXXXXXXXXXXXXXXXXXGAAAAOAAAAAAXXXXXXXXXXXXXXXXXXXXXXXXXXXXXXXXGXXXXXXXXXXXXXXXXXXXXXGAAAAXXXXXXXXXXXXXXXXXXXXXXXXXXXXXXXXXXXXXXX,0,0,0
546,37,33,4,187,376,0,0,380,372,8,XXXXXXXXXXXXXXXXXXXXXXGAAAOAAAXXXXXXXXXXXXXXGAXXXXXXXXXXXXXXXXXXXXGXXXXXXXXXXXXXXXXXXXXXGXXXXXXXXXXXXXXXXXXXXXXXXXXXXXXXXXXXXXXXXXXXGXXXXXXXXXXXXXXXXXXXXXGXXXXXXXXXXXXXXXXXXXXXGAAAAOAAAAAAXXXXXXXXXXGXXXXXXXXXXXXXXXXXXXXXGXXXXXXXXXXXXXXXXXXXXXGAAAAXXXXXXXXXXXXXXXXXGAAAXXXXXXXXXXXXXXXXXX,0,0,0
567,39,33,6,190,371,0,0,377,362,15,XXXXXXXXXXXXXXXXXXXXXXGAAAOAAOXXXXXXXXXXXXXXGAXXXXXXXXXXXXXXXXXXXXGXXXXXXXXXXXXXXXXXXXXXGXXXXXXXXXXXXXXXXXXXXXGXXXXXXXXXXXXXXXXXXXXXGXXXXXXXXXXXXXXXXXXXXXGXXXXXXXXXXXXXXXXXXXXXGAAAAOAOAAAAXXXXXXXXXXGXXXXXXXXXXXXXXXXXXXXXGXXXXXXXXXXXXXXXXXXXXXGAAAAAXXXXXXXXXXXXXXXXGAAAXXXXXXXXXXXXXXXXXX,0,0,0
588,40,34,6,198,362,0,0,368,351,17,XXXXXXXXXXXXXXXXXXXXXXGAAAOAAOAXXXXXXXXXXXXXGAXXXXXXXXXXXXXXXXXXXXGXXXXXXXXXXXXXXXXXXXXXGXXXXXXXXXXXXXXXXXXXXXGXXXXXXXXXXXXXXXXXXXXXGXXXXXXXXXXXXXXXXXXXXXGXXXXXXXXXXXXXXXXXXXXXGAAAAOAOAAAAXXXXXXXXXXGXXXXXXXXXXXXXXXXXXXXXGXXXXXXXXXXXXXXXXXXXXXGAAAAAXXXXXXXXXXXXXXXXGAAAXXXXXXXXXXXXXXXXXX,0,0,0
609,41,34,7,200,359,0,0,366,347,19,XXXXXXXXXXXXXXXXXXXXXXGAAAOAAOAXXXXXXXXXXXXXGAXXXXXXXXXXXXXXXXXXXXGXXXXXXXXXXXXXXXXXXXXXGXXXXXXXXXXXXXXXXXXXXXGXXXXXXXXXXXXXXXXXXXXXGXXXXXXXXXXXXXXXXXXXXXGXXXXXXXXXXXXXXXXXXXXXGAAAAOAOAAAAAXXXXXXXXXGXXXXXXXXXXXXXXXXXXXXXGXXXXXXXXXXXXXXXXXXXXXGOAAAAXXXXXXXXXXXXXXXXGAAAXXXXXXXXXXXXXXXXXX,0,0,0

630,42,35,7,209,349,0,0,356,336,20,XXXXXXXXXXXXXXXXXXXXXXGAAAOAAOAXXXXXXXXXXXXXGAXXXXXXXXXXXXXXXXXXXXGXXXXXXXXXXXXXXXXXXXXXGXXXXXXXXXXXXXXXXXXXXXGXXXXXXXXXXXXXXXXXXXXXGXXXXXXXXXXXXXXXXXXXXXGAXXXXXXXXXXXXXXXXXXXXGAAAAOAOAAAAAXXXXXXXXXGXXXXXXXXXXXXXXXXXXXXXGXXXXXXXXXXXXXXXXXXXXXGOAAAAXXXXXXXXXXXXXXXXGAAAXXXXXXXXXXXXXXXXXX,0,0,0
651,44,37,7,214,342,0,0,349,329,20,XXXXXXXXXXXXXXXXXXXXXXGAAAOAAOAAXXXXXXXXXXXXGAXXXXXXXXXXXXXXXXXXXXGXXXXXXXXXXXXXXXXXXXXXGXXXXXXXXXXXXXXXXXXXXXGXXXXXXXXXXXXXXXXXXXXXGAXXXXXXXXXXXXXXXXXXXXGAXXXXXXXXXXXXXXXXXXXXGAAAAOAOAAAAAXXXXXXXXXGXXXXXXXXXXXXXXXXXXXXXGXXXXXXXXXXXXXXXXXXXXXGOAAAAXXXXXXXXXXXXXXXXGAAAXXXXXXXXXXXXXXXXXX,0,0,0
672,44,37,7,222,334,0,0,341,319,22,XXXXXXXXXXXXXXXXXXXXXXGAAAOAAOAAXXXXXXXXXXXXGAXXXXXXXXXXXXXXXXXXXXGXXXXXXXXXXXXXXXXXXXXXGXXXXXXXXXXXXXXXXXXXXXGXXXXXXXXXXXXXXXXXXXXXGAXXXXXXXXXXXXXXXXXXXXGAXXXXXXXXXXXXXXXXXXXXGAAAAOAOAAAAAXXXXXXXXXGXXXXXXXXXXXXXXXXXXXXXGXXXXXXXXXXXXXXXXXXXXXGOAAAAXXXXXXXXXXXXXXXXGAAAXXXXXXXXXXXXXXXXXX,0,0,0
693,47,38,9,236,317,0,0,326,300,26,XXXXXXXXXXXXXXXXXXXXXXGAAAOAOOAAXXXXXXXXXXXXGAXXXXXXXXXXXXXXXXXXXXGXXXXXXXXXXXXXXXXXXXXXGXXXXXXXXXXXXXXXXXXXXXGXXXXXXXXXXXXXXXXXXXXXGAXXXXXXXXXXXXXXXXXXXXGAXXXXXXXXXXXXXXXXXXXXGAAAAOAOAAAAAXXXXXXXXXGAXXXXXXXXXXXXXXXXXXXXGAAXXXXXXXXXXXXXXXXXXXGOAAAAXXXXXXXXXXXXXXXXGAAAXXXXXXXXXXXXXXXXXX,0,0,0
714,47,37,10,242,311,0,0,321,293,28,XXXXXXXXXXXXXXXXXXXXXXGAAAOAOOAAXXXXXXXXXXXXGAXXXXXXXXXXXXXXXXXXXXGXXXXXXXXXXXXXXXXXXXXXGXXXXXXXXXXXXXXXXXXXXXGXXXXXXXXXXXXXXXXXXXXXGAXXXXXXXXXXXXXXXXXXXXGAXXXXXXXXXXXXXXXXXXXXGAAAAOAOAAAAAXXXXXXXXXGAXXXXXXXXXXXXXXXXXXXXGAAXXXXXXXXXXXXXXXXXXXGOAAAAXXXXXXXXXXXXXXXXGAAAXXXXXXXXXXXXXXXXXX,0,0,0

735,47,37,10,246,307,0,0,317,284,33,XXXXXXXXXXXXXXXXXXXXXXGAAAOAOOAAXXXXXXXXXXXXGAXXXXXXXXXXXXXXXXXXXXGXXXXXXXXXXXXXXXXXXXXXGXXXXXXXXXXXXXXXXXXXXXGXXXXXXXXXXXXXXXXXXXXXGAXXXXXXXXXXXXXXXXXXXXGAXXXXXXXXXXXXXXXXXXXXGAAAAOAOAAAAAXXXXXXXXXGAXXXXXXXXXXXXXXXXXXXXGAAXXXXXXXXXXXXXXXXXXXGOAAAAXXXXXXXXXXXXXXXXGAAAXXXXXXXXXXXXXXXXXX,0,0,0
756,48,37,11,251,301,0,0,312,275,37,GXXXXXXXXXXXXXXXXXXXXXGAAAOAOOAAXXXXXXXXXXXXGAXXXXXXXXXXXXXXXXXXXXGXXXXXXXXXXXXXXXXXXXXXGXXXXXXXXXXXXXXXXXXXXXGXXXXXXXXXXXXXXXXXXXXXGAXXXXXXXXXXXXXXXXXXXXGAXXXXXXXXXXXXXXXXXXXXGAOAAOAOAAAAAXXXXXXXXXGAXXXXXXXXXXXXXXXXXXXXGAAXXXXXXXXXXXXXXXXXXXGOAAAAXXXXXXXXXXXXXXXXGAAAXXXXXXXXXXXXXXXXXX,0,0,0
777,48,36,12,255,297,0,0,309,270,39,GXXXXXXXXXXXXXXXXXXXXXGAAAOAOOAAXXXXXXXXXXXXGAXXXXXXXXXXXXXXXXXXXXGXXXXXXXXXXXXXXXXXXXXXGXXXXXXXXXXXXXXXXXXXXXGXXXXXXXXXXXXXXXXXXXXXGAXXXXXXXXXXXXXXXXXXXXGAXXXXXXXXXXXXXXXXXXXXGAOAAOAOAAAAAXXXXXXXXXGAXXXXXXXXXXXXXXXXXXXXGAAXXXXXXXXXXXXXXXXXXXGOAAAAXXXXXXXXXXXXXXXXGOAAXXXXXXXXXXXXXXXXXX,0,0,0
798,49,37,12,256,295,0,0,307,269,38,GXXXXXXXXXXXXXXXXXXXXXGAAAOAOOAAXXXXXXXXXXXXGAXXXXXXXXXXXXXXXXXXXXGXXXXXXXXXXXXXXXXXXXXXGXXXXXXXXXXXXXXXXXXXXXGXXXXXXXXXXXXXXXXXXXXXGAXXXXXXXXXXXXXXXXXXXXGAAXXXXXXXXXXXXXXXXXXXGAOAAOAOAAAAAXXXXXXXXXGAXXXXXXXXXXXXXXXXXXXXGAAXXXXXXXXXXXXXXXXXXXGOAAAAXXXXXXXXXXXXXXXXGOAAXXXXXXXXXXXXXXXXXX,0,0,0
819,50,38,12,259,291,0,0,303,264,39,GAXXXXXXXXXXXXXXXXXXXXGAAAOAOOAAXXXXXXXXXXXXGAXXXXXXXXXXXXXXXXXXXXGXXXXXXXXXXXXXXXXXXXXXGXXXXXXXXXXXXXXXXXXXXXGXXXXXXXXXXXXXXXXXXXXXGAXXXXXXXXXXXXXXXXXXXXGAAXXXXXXXXXXXXXXXXXXXGAOAAOAOAAAAAXXXXXXXXXGAXXXXXXXXXXXXXXXXXXXXGAAXXXXXXXXXXXXXXXXXXXGOAAAAXXXXXXXXXXXXXXXXGOAAXXXXXXXXXXXXXXXXXX,0,0,0

840,52,40,12,257,291,0,0,302,259,43,GAAXXXXXXXXXXXXXXXXXXXGAAAOAOOAAXXXXXXXXXXXXGAXXXXXXXXXXXXXXXXXXXXGAXXXXXXXXXXXXXXXXXXXXGXXXXXXXXXXXXXXXXXXXXXGXXXXXXXXXXXXXXXXXXXXXGAXXXXXXXXXXXXXXXXXXXXGAAXXXXXXXXXXXXXXXXXXXGAOAAOAOAAAAAXXXXXXXXXGAXXXXXXXXXXXXXXXXXXXXGAAXXXXXXXXXXXXXXXXXXXGOAAAAXXXXXXXXXXXXXXXXGOAAXXXXXXXXXXXXXXXXXX,0,0,0
861,52,37,15,259,289,0,0,304,254,50,GAAXXXXXXXXXXXXXXXXXXXGAAAOAOOAAXXXXXXXXXXXXGAXXXXXXXXXXXXXXXXXXXXGAXXXXXXXXXXXXXXXXXXXXGXXXXXXXXXXXXXXXXXXXXXGXXXXXXXXXXXXXXXXXXXXXGOXXXXXXXXXXXXXXXXXXXXGAAXXXXXXXXXXXXXXXXXXXGOOAAOAOAAAAOXXXXXXXXXGAXXXXXXXXXXXXXXXXXXXXGAAXXXXXXXXXXXXXXXXXXXGOAAAAXXXXXXXXXXXXXXXXGOAAXXXXXXXXXXXXXXXXXX,0,0,0
882,54,38,16,263,283,0,0,299,248,51,GAAXXXXXXXXXXXXXXXXXXXGAAAOAOOOAXXXXXXXXXXXXGAXXXXXXXXXXXXXXXXXXXXGAXXXXXXXXXXXXXXXXXXXXGXXXXXXXXXXXXXXXXXXXXXGXXXXXXXXXXXXXXXXXXXXXGOXXXXXXXXXXXXXXXXXXXXGAAXXXXXXXXXXXXXXXXXXXGOOAAOAOAAAAOXXXXXXXXXGAXXXXXXXXXXXXXXXXXXXXGAAXXXXXXXXXXXXXXXXXXXGOAAAAAXXXXXXXXXXXXXXXGOAAAXXXXXXXXXXXXXXXXX,0,0,0
903,58,42,16,261,281,0,0,297,243,54,GAAXXXXXXXXXXXXXXXXXXXGAAAOAOOOAXXXXXXXXXXXXGAXXXXXXXXXXXXXXXXXXXXGAXXXXXXXXXXXXXXXXXXXXGXXXXXXXXXXXXXXXXXXXXXGXXXXXXXXXXXXXXXXXXXXXGOXXXXXXXXXXXXXXXXXXXXGAAAAXXXXXXXXXXXXXXXXXGOOAAOAOAAAAOAXXXXXXXXGAXXXXXXXXXXXXXXXXXXXXGAAXXXXXXXXXXXXXXXXXXXGOAAAAAAXXXXXXXXXXXXXXGOAAAXXXXXXXXXXXXXXXXX,0,0,0
924,58,41,17,261,281,0,0,298,238,60,GAAXXXXXXXXXXXXXXXXXXXGAAAOAOOOAXXXXXXXXXXXXGAXXXXXXXXXXXXXXXXXXXXGAXXXXXXXXXXXXXXXXXXXXGXXXXXXXXXXXXXXXXXXXXXGXXXXXXXXXXXXXXXXXXXXXGOXXXXXXXXXXXXXXXXXXXXGAAAAXXXXXXXXXXXXXXXXXGOOAAOAOOAAAOAXXXXXXXXGAXXXXXXXXXXXXXXXXXXXXGAAXXXXXXXXXXXXXXXXXXXGOAAAAAAXXXXXXXXXXXXXXGOAAAXXXXXXXXXXXXXXXXX,0,0,0

945,58,41,17,264,278,0,0,295,235,60,GAAXXXXXXXXXXXXXXXXXXXGAAAOAOOOAXXXXXXXXXXXXGAXXXXXXXXXXXXXXXXXXXXGAXXXXXXXXXXXXXXXXXXXXGXXXXXXXXXXXXXXXXXXXXXGXXXXXXXXXXXXXXXXXXXXXGOXXXXXXXXXXXXXXXXXXXXGAAAAXXXXXXXXXXXXXXXXXGOOAAOAOOAAAOAXXXXXXXXGAXXXXXXXXXXXXXXXXXXXXGAAXXXXXXXXXXXXXXXXXXXGOAAAAAAXXXXXXXXXXXXXXGOAAAXXXXXXXXXXXXXXXXX,0,0,0
966,59,40,19,269,272,0,0,291,230,61,GAAXXXXXXXXXXXXXXXXXXXGAAAOAOOOAXXXXXXXXXXXXGAXXXXXXXXXXXXXXXXXXXXGAAXXXXXXXXXXXXXXXXXXXGXXXXXXXXXXXXXXXXXXXXXGXXXXXXXXXXXXXXXXXXXXXGOXXXXXXXXXXXXXXXXXXXXGAAAAXXXXXXXXXXXXXXXXXGOOAAOOOOAAAOOXXXXXXXXGAXXXXXXXXXXXXXXXXXXXXGAAXXXXXXXXXXXXXXXXXXXGOAAAAAAXXXXXXXXXXXXXXGOAAAXXXXXXXXXXXXXXXXX,0,0,0
987,60,40,20,276,264,0,0,284,224,60,GAAXXXXXXXXXXXXXXXXXXXGAAAOAOOOAXXXXXXXXXXXXGAXXXXXXXXXXXXXXXXXXXXGAAXXXXXXXXXXXXXXXXXXXGXXXXXXXXXXXXXXXXXXXXXGAXXXXXXXXXXXXXXXXXXXXGOXXXXXXXXXXXXXXXXXXXXGAAAAXXXXXXXXXXXXXXXXXGOOAAOOOOAAAOOXXXXXXXXGAXXXXXXXXXXXXXXXXXXXXGAAXXXXXXXXXXXXXXXXXXXGOAAAAAAXXXXXXXXXXXXXXGOAAAXXXXXXXXXXXXXXXXX,0,0,0
1008,60,40,20,276,264,0,0,284,226,58,GAAXXXXXXXXXXXXXXXXXXXGAAAOAOOOAXXXXXXXXXXXXGAXXXXXXXXXXXXXXXXXXXXGAAXXXXXXXXXXXXXXXXXXXGXXXXXXXXXXXXXXXXXXXXXGAXXXXXXXXXXXXXXXXXXXXGOXXXXXXXXXXXXXXXXXXXXGAAAAXXXXXXXXXXXXXXXXXGOOAAOOOOAAAOOXXXXXXXXGAXXXXXXXXXXXXXXXXXXXXGAAXXXXXXXXXXXXXXXXXXXGOAAAAAAXXXXXXXXXXXXXXGOAAAXXXXXXXXXXXXXXXXX,0,0,0
1029,61,40,21,276,263,0,0,284,223,61,GAAXXXXXXXXXXXXXXXXXXXGAAAOAOOOAXXXXXXXXXXXXGAXXXXXXXXXXXXXXXXXXXXGAAXXXXXXXXXXXXXXXXXXXGXXXXXXXXXXXXXXXXXXXXXGAXXXXXXXXXXXXXXXXXXXXGOXXXXXXXXXXXXXXXXXXXXGAAAAXXXXXXXXXXXXXXXXXGOOAAOOOOAAAOOXXXXXXXXGAAXXXXXXXXXXXXXXXXXXXGAAXXXXXXXXXXXXXXXXXXXGOAAAAAAXXXXXXXXXXXXXXGOAAAXXXXXXXXXXXXXXXXX,0,0,0

1050,61,40,21,273,266,0,0,287,229,58,GAAXXXXXXXXXXXXXXXXXXXGAAAOAOOOAXXXXXXXXXXXXGAXXXXXXXXXXXXXXXXXXXXGAAXXXXXXXXXXXXXXXXXXXGXXXXXXXXXXXXXXXXXXXXXGAXXXXXXXXXXXXXXXXXXXXGOXXXXXXXXXXXXXXXXXXXXGAAAAXXXXXXXXXXXXXXXXXGOOAAOOOOAAAOOXXXXXXXXGAAXXXXXXXXXXXXXXXXXXXGAAXXXXXXXXXXXXXXXXXXXGOAAAAAAXXXXXXXXXXXXXXGOAAAXXXXXXXXXXXXXXXXX,0,0,0
1071,61,40,21,272,267,0,0,288,231,57,GAAXXXXXXXXXXXXXXXXXXXGAAAOAOOOAXXXXXXXXXXXXGAXXXXXXXXXXXXXXXXXXXXGAAXXXXXXXXXXXXXXXXXXXGXXXXXXXXXXXXXXXXXXXXXGAXXXXXXXXXXXXXXXXXXXXGOXXXXXXXXXXXXXXXXXXXXGAAAAXXXXXXXXXXXXXXXXXGOOAAOOOOAAAOOXXXXXXXXGAAXXXXXXXXXXXXXXXXXXXGAAXXXXXXXXXXXXXXXXXXXGOAAAAAAXXXXXXXXXXXXXXGOAAAXXXXXXXXXXXXXXXXX,0,0,0
1092,63,40,23,270,267,0,0,290,229,61,GAAXXXXXXXXXXXXXXXXXXXGAAAOAOOOAAAXXXXXXXXXXGAXXXXXXXXXXXXXXXXXXXXGAAXXXXXXXXXXXXXXXXXXXGXXXXXXXXXXXXXXXXXXXXXGAXXXXXXXXXXXXXXXXXXXXGOXXXXXXXXXXXXXXXXXXXXGAAAAXXXXXXXXXXXXXXXXXGOOAAOOOOAAAOOXXXXXXXXGAAXXXXXXXXXXXXXXXXXXXGAAXXXXXXXXXXXXXXXXXXXGOAAAAOAXXXXXXXXXXXXXXGOAOAXXXXXXXXXXXXXXXXX,0,0,0
1113,66,43,23,268,266,0,0,289,226,63,GAAXXXXXXXXXXXXXXXXXXXGAAAOAOOOAAAXXXXXXXXXXGAAXXXXXXXXXXXXXXXXXXXGAAAXXXXXXXXXXXXXXXXXXGXXXXXXXXXXXXXXXXXXXXXGAXXXXXXXXXXXXXXXXXXXXGOXXXXXXXXXXXXXXXXXXXXGAAAAXXXXXXXXXXXXXXXXXGOOAAOOOOAAAOOAXXXXXXXGAAXXXXXXXXXXXXXXXXXXXGAAXXXXXXXXXXXXXXXXXXXGOAAAAOAXXXXXXXXXXXXXXGOAOAXXXXXXXXXXXXXXXXX,0,0,0
1134,66,42,24,266,268,0,0,292,226,66,GAAXXXXXXXXXXXXXXXXXXXGAAAOAOOOAAAXXXXXXXXXXGAAXXXXXXXXXXXXXXXXXXXGAAAXXXXXXXXXXXXXXXXXXGXXXXXXXXXXXXXXXXXXXXXGAXXXXXXXXXXXXXXXXXXXXGOXXXXXXXXXXXXXXXXXXXXGAAAAXXXXXXXXXXXXXXXXXGOOOAOOOOAAAOOAXXXXXXXGAAXXXXXXXXXXXXXXXXXXXGAAXXXXXXXXXXXXXXXXXXXGOAAAAOAXXXXXXXXXXXXXXGOAOAXXXXXXXXXXXXXXXXX,0,0,0

1155,68,44,24,267,265,0,0,289,227,62,GAAXXXXXXXXXXXXXXXXXXXGAAAOAOOOAAAAXXXXXXXXXGAAXXXXXXXXXXXXXXXXXXXGAAAXXXXXXXXXXXXXXXXXXGXXXXXXXXXXXXXXXXXXXXXGAXXXXXXXXXXXXXXXXXXXXGOXXXXXXXXXXXXXXXXXXXXGAAAAAXXXXXXXXXXXXXXXXGOOOAOOOOAAAOOAXXXXXXXGAAXXXXXXXXXXXXXXXXXXXGAAXXXXXXXXXXXXXXXXXXXGOAAAAOAXXXXXXXXXXXXXXGOAOAXXXXXXXXXXXXXXXXX,0,0,0
1176,69,43,26,267,264,0,0,289,226,63,GAAXXXXXXXXXXXXXXXXXXXGAAAOAOOOAAAAXXXXXXXXXGOAXXXXXXXXXXXXXXXXXXXGAAAXXXXXXXXXXXXXXXXXXGAXXXXXXXXXXXXXXXXXXXXGAXXXXXXXXXXXXXXXXXXXXGOXXXXXXXXXXXXXXXXXXXXGAOAAAXXXXXXXXXXXXXXXXGOOOAOOOOAAAOOAXXXXXXXGAAXXXXXXXXXXXXXXXXXXXGAAXXXXXXXXXXXXXXXXXXXGOAAAAOAXXXXXXXXXXXXXXGOAOAXXXXXXXXXXXXXXXXX,0,0,0
1197,72,44,28,262,266,0,0,294,224,70,GAAXXXXXXXXXXXXXXXXXXXGAAAOAOOOAAAAXXXXXXXXXGOAXXXXXXXXXXXXXXXXXXXGAAAAXXXXXXXXXXXXXXXXXGAXXXXXXXXXXXXXXXXXXXXGAXXXXXXXXXXXXXXXXXXXXGOXXXXXXXXXXXXXXXXXXXXGAOAAAXXXXXXXXXXXXXXXXGOOOAOOOOAAAOOAXXXXXXXGAAXXXXXXXXXXXXXXXXXXXGAOAAXXXXXXXXXXXXXXXXXGOAAAOOAXXXXXXXXXXXXXXGOAOAXXXXXXXXXXXXXXXXX,0,0,0
1218,74,45,29,260,266,0,0,295,224,71,GAAXXXXXXXXXXXXXXXXXXXGAAAOAOOOAAAAXXXXXXXXXGOAXXXXXXXXXXXXXXXXXXXGAAAAXXXXXXXXXXXXXXXXXGAXXXXXXXXXXXXXXXXXXXXGAXXXXXXXXXXXXXXXXXXXXGOXXXXXXXXXXXXXXXXXXXXGAOAAAXXXXXXXXXXXXXXXXGOOOAOOOOAAAOOAAXXXXXXGAAAXXXXXXXXXXXXXXXXXXGAOAAXXXXXXXXXXXXXXXXXGOAAAOOAXXXXXXXXXXXXXXGOAOAXXXXXXXXXXXXXXXXX,0,0,0
1239,77,46,31,259,264,0,0,295,223,72,GAAXXXXXXXXXXXXXXXXXXXGAAAOAOOOAAAAXXXXXXXXXGOAXXXXXXXXXXXXXXXXXXXGAAAAXXXXXXXXXXXXXXXXXGAAXXXXXXXXXXXXXXXXXXXGAXXXXXXXXXXXXXXXXXXXXGOXXXXXXXXXXXXXXXXXXXXGAOAAAXXXXXXXXXXXXXXXXGOOOOOOOOAAAOOAAAXXXXXGAAAXXXXXXXXXXXXXXXXXXGAOAAXXXXXXXXXXXXXXXXXGOAAOOOAXXXXXXXXXXXXXXGOAOAAXXXXXXXXXXXXXXXX,0,0,0

1260,78,46,32,261,261,0,0,292,222,70,GAAXXXXXXXXXXXXXXXXXXXGAAAOAOOOAOAAXXXXXXXXXGOAXXXXXXXXXXXXXXXXXXXGAAAAXXXXXXXXXXXXXXXXXGAAXXXXXXXXXXXXXXXXXXXGAXXXXXXXXXXXXXXXXXXXXGOXXXXXXXXXXXXXXXXXXXXGAOAAAXXXXXXXXXXXXXXXXGOOOOOOOOAAAOOAAAXXXXXGAAAXXXXXXXXXXXXXXXXXXGAOAAXXXXXXXXXXXXXXXXXGOAAOOOAXXXXXXXXXXXXXXGOAOAAAXXXXXXXXXXXXXXX,0,0,0
1281,79,43,36,263,258,0,0,293,219,74,GAAXXXXXXXXXXXXXXXXXXXGAAAOAOOOAOAAXXXXXXXXXGOAXXXXXXXXXXXXXXXXXXXGAOAAXXXXXXXXXXXXXXXXXGAAAXXXXXXXXXXXXXXXXXXGAXXXXXXXXXXXXXXXXXXXXGOXXXXXXXXXXXXXXXXXXXXGAOAAAXXXXXXXXXXXXXXXXGOOOOOOOOAOAOOAAAXXXXXGAAAXXXXXXXXXXXXXXXXXXGAOAAXXXXXXXXXXXXXXXXXGOAOOOOAXXXXXXXXXXXXXXGOAOAAAXXXXXXXXXXXXXXX,0,0,0
1302,80,44,36,263,257,0,0,293,220,73,GAAAXXXXXXXXXXXXXXXXXXGAAAOAOOOAOAAXXXXXXXXXGOAXXXXXXXXXXXXXXXXXXXGAOAAXXXXXXXXXXXXXXXXXGAAAXXXXXXXXXXXXXXXXXXGAXXXXXXXXXXXXXXXXXXXXGOXXXXXXXXXXXXXXXXXXXXGAOAAAXXXXXXXXXXXXXXXXGOOOOOOOOAOAOOAAAXXXXXGAAAXXXXXXXXXXXXXXXXXXGAOAAXXXXXXXXXXXXXXXXXGOAOOOOAXXXXXXXXXXXXXXGOAOAAAXXXXXXXXXXXXXXX,0,0,0
1323,81,43,38,255,264,0,0,302,223,79,GAAAXXXXXXXXXXXXXXXXXXGAAAOAOOOAOAAXXXXXXXXXGOAXXXXXXXXXXXXXXXXXXXGAOAAXXXXXXXXXXXXXXXXXGAAAXXXXXXXXXXXXXXXXXXGAXXXXXXXXXXXXXXXXXXXXGOXXXXXXXXXXXXXXXXXXXXGAOAAAXXXXXXXXXXXXXXXXGOOOOOOOOAOAOOAAAXXXXXGAOAXXXXXXXXXXXXXXXXXXGAOAAAXXXXXXXXXXXXXXXXGOAOOOOOXXXXXXXXXXXXXXGOAOAAAXXXXXXXXXXXXXXX,0,0,0
1344,82,42,40,253,265,0,0,304,226,78,GAAAXXXXXXXXXXXXXXXXXXGAAAOAOOOAOAAXXXXXXXXXGOAXXXXXXXXXXXXXXXXXXXGAOOAXXXXXXXXXXXXXXXXXGAAAXXXXXXXXXXXXXXXXXXGAXXXXXXXXXXXXXXXXXXXXGOXXXXXXXXXXXXXXXXXXXXGAOAAAXXXXXXXXXXXXXXXXGOOOOOOOOAOAOOAAAAXXXXGAOAXXXXXXXXXXXXXXXXXXGAOAAAXXXXXXXXXXXXXXXXGOAOOOOOXXXXXXXXXXXXXXGOAOAAAXXXXXXXXXXXXXXX,0,0,0

1365,84,43,41,251,265,0,0,306,222,84,GAAAXXXXXXXXXXXXXXXXXXGAAAOAOOOAOAAXXXXXXXXXGOAXXXXXXXXXXXXXXXXXXXGAOOAAXXXXXXXXXXXXXXXXGAAAXXXXXXXXXXXXXXXXXXGAXXXXXXXXXXXXXXXXXXXXGOXXXXXXXXXXXXXXXXXXXXGAOAAOXXXXXXXXXXXXXXXXGOOOOOOOOAOAOOAAAAAXXXGAOAXXXXXXXXXXXXXXXXXXGAOAAAXXXXXXXXXXXXXXXXGOAOOOOOXXXXXXXXXXXXXXGOAOAAAXXXXXXXXXXXXXXX,0,0,0
1386,86,44,42,252,262,0,0,304,218,86,GAAAAAXXXXXXXXXXXXXXXXGAAAOAOOOAOAAXXXXXXXXXGOAXXXXXXXXXXXXXXXXXXXGAOOAAXXXXXXXXXXXXXXXXGAAAXXXXXXXXXXXXXXXXXXGAXXXXXXXXXXXXXXXXXXXXGOXXXXXXXXXXXXXXXXXXXXGAOAAOXXXXXXXXXXXXXXXXGOOOOOOOOAOAOOAAAAAXXXGAOAXXXXXXXXXXXXXXXXXXGAOAAAXXXXXXXXXXXXXXXXGOAOOOOOXXXXXXXXXXXXXXGOAOAAAXXXXXXXXXXXXXXX,0,0,0
1407,87,45,42,247,266,0,0,308,222,86,GAAAAAXXXXXXXXXXXXXXXXGAAAOAOOOAOAAXXXXXXXXXGOAAXXXXXXXXXXXXXXXXXXGAOOAAXXXXXXXXXXXXXXXXGAAAXXXXXXXXXXXXXXXXXXGAXXXXXXXXXXXXXXXXXXXXGOXXXXXXXXXXXXXXXXXXXXGAOAAOXXXXXXXXXXXXXXXXGOOOOOOOOAOAOOAAAAAXXXGAOAXXXXXXXXXXXXXXXXXXGAOAAAXXXXXXXXXXXXXXXXGOAOOOOOXXXXXXXXXXXXXXGOAOAAAXXXXXXXXXXXXXXX,0,0,0
1428,88,45,43,246,266,0,0,309,224,85,GAAAAAXXXXXXXXXXXXXXXXGAAAOAOOOAOAOAXXXXXXXXGOAAXXXXXXXXXXXXXXXXXXGAOOAAXXXXXXXXXXXXXXXXGAAAXXXXXXXXXXXXXXXXXXGAXXXXXXXXXXXXXXXXXXXXGOXXXXXXXXXXXXXXXXXXXXGAOAAOXXXXXXXXXXXXXXXXGOOOOOOOOAOAOOAAAAAXXXGAOAXXXXXXXXXXXXXXXXXXGAOAAAXXXXXXXXXXXXXXXXGOAOOOOOXXXXXXXXXXXXXXGOAOAAAXXXXXXXXXXXXXXX,0,0,0
1449,90,46,44,248,262,0,0,306,220,86,GAAAAAXXXXXXXXXXXXXXXXGAAAOAOOOAOAOAXXXXXXXXGOAAXXXXXXXXXXXXXXXXXXGAOOAAXXXXXXXXXXXXXXXXGAAAXXXXXXXXXXXXXXXXXXGAXXXXXXXXXXXXXXXXXXXXGOXXXXXXXXXXXXXXXXXXXXGAOAAOXXXXXXXXXXXXXXXXGOOOOOOOOAOAOOAAAAAXXXGAOAAXXXXXXXXXXXXXXXXXGAOAAAXXXXXXXXXXXXXXXXGOAOOOOOXXXXXXXXXXXXXXGOOOAAAAXXXXXXXXXXXXXX,0,0,0

1470,90,46,44,247,263,0,0,307,225,82,GAAAAAXXXXXXXXXXXXXXXXGAAAOAOOOAOAOAXXXXXXXXGOAAXXXXXXXXXXXXXXXXXXGAOOAAXXXXXXXXXXXXXXXXGAAAXXXXXXXXXXXXXXXXXXGAXXXXXXXXXXXXXXXXXXXXGOXXXXXXXXXXXXXXXXXXXXGAOAAOXXXXXXXXXXXXXXXXGOOOOOOOOAOAOOAAAAAXXXGAOAAXXXXXXXXXXXXXXXXXGAOAAAXXXXXXXXXXXXXXXXGOAOOOOOXXXXXXXXXXXXXXGOOOAAAAXXXXXXXXXXXXXX,0,0,0
1491,92,47,45,245,263,0,0,308,219,89,GAAAAAAXXXXXXXXXXXXXXXGAAAOAOOOAOAOAXXXXXXXXGOAAXXXXXXXXXXXXXXXXXXGAOOAAXXXXXXXXXXXXXXXXGOAAXXXXXXXXXXXXXXXXXXGAXXXXXXXXXXXXXXXXXXXXGOXXXXXXXXXXXXXXXXXXXXGAOAAOXXXXXXXXXXXXXXXXGOOOOOOOOAOAOOAAAAAXXXGAOAAXXXXXXXXXXXXXXXXXGAOAAAXXXXXXXXXXXXXXXXGOAOOOOOXXXXXXXXXXXXXXGOOOAAAAAXXXXXXXXXXXXX,0,0,0
1512,93,47,46,244,263,0,0,309,223,86,GAAAAAOXXXXXXXXXXXXXXXGAAAOAOOOAOAOAXXXXXXXXGOAAXXXXXXXXXXXXXXXXXXGAOOAAXXXXXXXXXXXXXXXXGOAAXXXXXXXXXXXXXXXXXXGAAXXXXXXXXXXXXXXXXXXXGOXXXXXXXXXXXXXXXXXXXXGAOAAOXXXXXXXXXXXXXXXXGOOOOOOOOAOAOOAAAAAXXXGAOAAXXXXXXXXXXXXXXXXXGAOAAAXXXXXXXXXXXXXXXXGOAOOOOOXXXXXXXXXXXXXXGOOOAAAAAXXXXXXXXXXXXX,0,0,0
1533,94,48,46,247,259,0,0,305,220,85,GAAAAAOXXXXXXXXXXXXXXXGAAAOAOOOAOAOAXXXXXXXXGOAAXXXXXXXXXXXXXXXXXXGAOOAAXXXXXXXXXXXXXXXXGOAAXXXXXXXXXXXXXXXXXXGAAXXXXXXXXXXXXXXXXXXXGOXXXXXXXXXXXXXXXXXXXXGAOAAOAXXXXXXXXXXXXXXXGOOOOOOOOAOAOOAAAAAXXXGAOAAXXXXXXXXXXXXXXXXXGAOAAAXXXXXXXXXXXXXXXXGOAOOOOOXXXXXXXXXXXXXXGOOOAAAAAXXXXXXXXXXXXX,0,0,0
1554,95,48,47,240,265,0,0,312,228,84,GAAAAAOXXXXXXXXXXXXXXXGAAAOAOOOAOAOAAXXXXXXXGOAAXXXXXXXXXXXXXXXXXXGAOOAAXXXXXXXXXXXXXXXXGOOAXXXXXXXXXXXXXXXXXXGAAXXXXXXXXXXXXXXXXXXXGOXXXXXXXXXXXXXXXXXXXXGAOAAOAXXXXXXXXXXXXXXXGOOOOOOOOAOAOOAAAAAXXXGAOAAXXXXXXXXXXXXXXXXXGAOAAAXXXXXXXXXXXXXXXXGOAOOOOOXXXXXXXXXXXXXXGOOOAAAAAXXXXXXXXXXXXX,0,0,0

1575,95,47,48,237,268,0,0,316,228,88,GAAAAAOXXXXXXXXXXXXXXXGOAAOAOOOAOAOAAXXXXXXXGOAAXXXXXXXXXXXXXXXXXXGAOOAAXXXXXXXXXXXXXXXXGOOAXXXXXXXXXXXXXXXXXXGAAXXXXXXXXXXXXXXXXXXXGOXXXXXXXXXXXXXXXXXXXXGAOAAOAXXXXXXXXXXXXXXXGOOOOOOOOAOAOOAAAAAXXXGAOAAXXXXXXXXXXXXXXXXXGAOAAAXXXXXXXXXXXXXXXXGOAOOOOOXXXXXXXXXXXXXXGOOOAAAAAXXXXXXXXXXXXX,0,0,0
1596,96,46,50,233,271,0,0,321,227,94,GAAAAAOXXXXXXXXXXXXXXXGOAAOAOOOAOAOAAXXXXXXXGOAAAXXXXXXXXXXXXXXXXXGAOOAAXXXXXXXXXXXXXXXXGOOAXXXXXXXXXXXXXXXXXXGAAXXXXXXXXXXXXXXXXXXXGOXXXXXXXXXXXXXXXXXXXXGAOAAOAXXXXXXXXXXXXXXXGOOOOOOOOAOAOOAAAAAXXXGAOAAXXXXXXXXXXXXXXXXXGAOAAAXXXXXXXXXXXXXXXXGOOOOOOOXXXXXXXXXXXXXXGOOOAAAAOXXXXXXXXXXXXX,0,0,0
1617,98,48,50,231,271,0,0,320,228,92,GAAAAAOXXXXXXXXXXXXXXXGOAAOAOOOAOAOAAXXXXXXXGOAAAXXXXXXXXXXXXXXXXXGAOOAAXXXXXXXXXXXXXXXXGOOAXXXXXXXXXXXXXXXXXXGAAXXXXXXXXXXXXXXXXXXXGOXXXXXXXXXXXXXXXXXXXXGAOAAOAAAXXXXXXXXXXXXXGOOOOOOOOAOAOOAAAAAXXXGAOAAXXXXXXXXXXXXXXXXXGAOAAAXXXXXXXXXXXXXXXXGOOOOOOOXXXXXXXXXXXXXXGOOOAAAAOXXXXXXXXXXXXX,0,0,0
1638,99,48,51,231,270,0,0,321,227,94,GAAAAAOXXXXXXXXXXXXXXXGOAAOAOOOAOAOAAXXXXXXXGOAAAXXXXXXXXXXXXXXXXXGAOOAAXXXXXXXXXXXXXXXXGOOAXXXXXXXXXXXXXXXXXXGAAXXXXXXXXXXXXXXXXXXXGOXXXXXXXXXXXXXXXXXXXXGAOAAOAOAXXXXXXXXXXXXXGOOOOOOOOAOAOOAAAAAAXXGAOAAXXXXXXXXXXXXXXXXXGAOAAAXXXXXXXXXXXXXXXXGOOOOOOOXXXXXXXXXXXXXXGOOOAAAAOXXXXXXXXXXXXX,0,0,0
1659,102,51,51,232,266,0,0,317,224,93,GAAAAAOXXXXXXXXXXXXXXXGOAAOAOOOAOAOAAXXXXXXXGOAAAXXXXXXXXXXXXXXXXXGAOOAAXXXXXXXXXXXXXXXXGOOAXXXXXXXXXXXXXXXXXXGAAXXXXXXXXXXXXXXXXXXXGOXXXXXXXXXXXXXXXXXXXXGAOAAOAOAAAXXXXXXXXXXXGOOOOOOOOAOAOOAAAAAAAXGAOAAXXXXXXXXXXXXXXXXXGAOAAAXXXXXXXXXXXXXXXXGOOOOOOOXXXXXXXXXXXXXXGOOOAAAAOXXXXXXXXXXXXX,0,0,0

1680,103,51,52,239,258,0,0,310,221,89,GAAAAAOXXXXXXXXXXXXXXXGOAAOAOOOAOAOAAXXXXXXXGOAAAXXXXXXXXXXXXXXXXXGAOOAAXXXXXXXXXXXXXXXXGOOAXXXXXXXXXXXXXXXXXXGAAXXXXXXXXXXXXXXXXXXXGOXXXXXXXXXXXXXXXXXXXXGAOAAOAOAAAXXXXXXXXXXXGOOOOOOOOAOAOOAAAAAAAAGAOOAXXXXXXXXXXXXXXXXXGAOAAAXXXXXXXXXXXXXXXXGOOOOOOOXXXXXXXXXXXXXXGOOOAAAAOXXXXXXXXXXXXX,0,0,0
1701,104,50,54,241,255,0,0,309,222,87,GAAAAAOAXXXXXXXXXXXXXXGOOAOAOOOAOAOAAXXXXXXXGOAAAXXXXXXXXXXXXXXXXXGAOOAAXXXXXXXXXXXXXXXXGOOAXXXXXXXXXXXXXXXXXXGAAXXXXXXXXXXXXXXXXXXXGOXXXXXXXXXXXXXXXXXXXXGAOAAOAOAAAXXXXXXXXXXXGOOOOOOOOAOAOOAAAAAAAAGAOOAXXXXXXXXXXXXXXXXXGOOAAAXXXXXXXXXXXXXXXXGOOOOOOOXXXXXXXXXXXXXXGOOOAAAAOXXXXXXXXXXXXX,0,0,0
1722,104,47,57,244,252,0,0,309,223,86,GAAAAOOAXXXXXXXXXXXXXXGOOAOAOOOAOAOAAXXXXXXXGOAAAXXXXXXXXXXXXXXXXXGAOOOAXXXXXXXXXXXXXXXXGOOAXXXXXXXXXXXXXXXXXXGAAXXXXXXXXXXXXXXXXXXXGOXXXXXXXXXXXXXXXXXXXXGAOAOOAOAAAXXXXXXXXXXXGOOOOOOOOAOAOOAAAAAAAAGAOOAXXXXXXXXXXXXXXXXXGOOAAAXXXXXXXXXXXXXXXXGOOOOOOOXXXXXXXXXXXXXXGOOOAAAAOXXXXXXXXXXXXX,0,0,0
1743,107,48,59,242,251,0,0,310,225,85,GAAAOOOAAAXXXXXXXXXXXXGOOAOAOOOAOAOAAXXXXXXXGOAAAAXXXXXXXXXXXXXXXXGOOOOAXXXXXXXXXXXXXXXXGOOAXXXXXXXXXXXXXXXXXXGAAXXXXXXXXXXXXXXXXXXXGOXXXXXXXXXXXXXXXXXXXXGAOAOOAOAAAXXXXXXXXXXXGOOOOOOOOAOAOOAAAAAAAAGAOOAXXXXXXXXXXXXXXXXXGOOAAAXXXXXXXXXXXXXXXXGOOOOOOOXXXXXXXXXXXXXXGOOOAAAAOXXXXXXXXXXXXX,0,0,0
1764,107,47,60,245,248,0,0,307,222,85,GAAAOOOAAAXXXXXXXXXXXXGOOAOAOOOAOAOAAXXXXXXXGOAAAAXXXXXXXXXXXXXXXXGOOOOAXXXXXXXXXXXXXXXXGOOAXXXXXXXXXXXXXXXXXXGAAXXXXXXXXXXXXXXXXXXXGOXXXXXXXXXXXXXXXXXXXXGAOAOOAOAAAXXXXXXXXXXXGOOOOOOOOAOAOOAAAAAAAAGAOOAXXXXXXXXXXXXXXXXXGOOAAAXXXXXXXXXXXXXXXXGOOOOOOOXXXXXXXXXXXXXXGOOOAAAAOXXXXXXXXXXXXX,0,0,0

1785,108,47,61,247,245,0,0,306,225,81,GAAAOOOAAAXXXXXXXXXXXXGOOAOAOOOAOAOAAXXXXXXXGOAAAAXXXXXXXXXXXXXXXXGOOOOAXXXXXXXXXXXXXXXXGOOAAXXXXXXXXXXXXXXXXXGAAXXXXXXXXXXXXXXXXXXXGOXXXXXXXXXXXXXXXXXXXXGAOAOOAOAAAXXXXXXXXXXXGOOOOOOOOAOAOOAAAAAAAAGAOOAXXXXXXXXXXXXXXXXXGOOAAAXXXXXXXXXXXXXXXXGOOOOOOOXXXXXXXXXXXXXXGOOOAAAAOXXXXXXXXXXXXX,0,0,0
1806,108,44,64,242,250,0,0,314,230,84,GAAAOOOAAAXXXXXXXXXXXXGOOAOOOOOAOAOAAXXXXXXXGOAAAAXXXXXXXXXXXXXXXXGOOOOAXXXXXXXXXXXXXXXXGOOAAXXXXXXXXXXXXXXXXXGAAXXXXXXXXXXXXXXXXXXXGOXXXXXXXXXXXXXXXXXXXXGAOOOOAOAAAXXXXXXXXXXXGOOOOOOOOAOAOOOAAAAAAAGAOOAXXXXXXXXXXXXXXXXXGOOAAAXXXXXXXXXXXXXXXXGOOOOOOOXXXXXXXXXXXXXXGOOOAAAAOXXXXXXXXXXXXX,0,0,0
1827,109,43,66,240,251,0,0,317,231,86,GAAAOOOAAAXXXXXXXXXXXXGOOAOOOOOAOAOOAXXXXXXXGOAAAAAXXXXXXXXXXXXXXXGOOOOAXXXXXXXXXXXXXXXXGOOAAXXXXXXXXXXXXXXXXXGAAXXXXXXXXXXXXXXXXXXXGOXXXXXXXXXXXXXXXXXXXXGOOOOOAOAAAXXXXXXXXXXXGOOOOOOOOAOAOOOAAAAAAAGAOOAXXXXXXXXXXXXXXXXXGOOAAAXXXXXXXXXXXXXXXXGOOOOOOOXXXXXXXXXXXXXXGOOOAAAAOXXXXXXXXXXXXX,0,0,0
1848,110,44,66,230,260,0,0,325,238,87,GAAAOOOAAAXXXXXXXXXXXXGOOAOOOOOAOAOOAXXXXXXXGOAAAAAAXXXXXXXXXXXXXXGOOOOAXXXXXXXXXXXXXXXXGOOAAXXXXXXXXXXXXXXXXXGAAXXXXXXXXXXXXXXXXXXXGOXXXXXXXXXXXXXXXXXXXXGOOOOOAOAAAXXXXXXXXXXXGOOOOOOOOAOAOOOAAAAAAAGAOOAXXXXXXXXXXXXXXXXXGOOAAAXXXXXXXXXXXXXXXXGOOOOOOOXXXXXXXXXXXXXXGOOOAAAAOXXXXXXXXXXXXX,0,0,0
1869,110,44,66,225,265,0,0,331,241,90,GAAAOOOAAAXXXXXXXXXXXXGOOAOOOOOAOAOOAXXXXXXXGOAAAAAAXXXXXXXXXXXXXXGOOOOAXXXXXXXXXXXXXXXXGOOAAXXXXXXXXXXXXXXXXXGAAXXXXXXXXXXXXXXXXXXXGOXXXXXXXXXXXXXXXXXXXXGOOOOOAOAAAXXXXXXXXXXXGOOOOOOOOAOAOOOAAAAAAAGAOOAXXXXXXXXXXXXXXXXXGOOAAAXXXXXXXXXXXXXXXXGOOOOOOOXXXXXXXXXXXXXXGOOOAAAAOXXXXXXXXXXXXX,0,0,0

1890,111,44,67,223,266,0,0,332,242,90,GAAAOOOAAAXXXXXXXXXXXXGOOAOOOOOAOAOOAXXXXXXXGOAAAAOAXXXXXXXXXXXXXXGOOOOAXXXXXXXXXXXXXXXXGOOAAXXXXXXXXXXXXXXXXXGAAXXXXXXXXXXXXXXXXXXXGOXXXXXXXXXXXXXXXXXXXXGOOOOOAOAAAXXXXXXXXXXXGOOOOOOOOAOAOOOAAAAAAAGAOOAXXXXXXXXXXXXXXXXXGOOAAAXXXXXXXXXXXXXXXXGOOOOOOOAXXXXXXXXXXXXXGOOOAAAAOXXXXXXXXXXXXX,0,0,0
1911,111,44,67,223,266,0,0,333,245,88,GAAAOOOAAAXXXXXXXXXXXXGOOAOOOOOAOAOOAXXXXXXXGOAAAAOAXXXXXXXXXXXXXXGOOOOAXXXXXXXXXXXXXXXXGOOAAXXXXXXXXXXXXXXXXXGAAXXXXXXXXXXXXXXXXXXXGOXXXXXXXXXXXXXXXXXXXXGOOOOOAOAAAXXXXXXXXXXXGOOOOOOOOAOAOOOAAAAAAAGAOOAXXXXXXXXXXXXXXXXXGOOAAAXXXXXXXXXXXXXXXXGOOOOOOOAXXXXXXXXXXXXXGOOOAAAAOXXXXXXXXXXXXX,0,0,0
1932,111,43,68,223,266,0,0,333,243,90,GAAAOOOAAAXXXXXXXXXXXXGOOAOOOOOAOAOOAXXXXXXXGOAAAAOAXXXXXXXXXXXXXXGOOOOAXXXXXXXXXXXXXXXXGOOAAXXXXXXXXXXXXXXXXXGAAXXXXXXXXXXXXXXXXXXXGOXXXXXXXXXXXXXXXXXXXXGOOOOOAOAAAXXXXXXXXXXXGOOOOOOOOOOAOOOAAAAAAAGAOOAXXXXXXXXXXXXXXXXXGOOAAAXXXXXXXXXXXXXXXXGOOOOOOOAXXXXXXXXXXXXXGOOOAAAAOXXXXXXXXXXXXX,0,0,0
1953,114,45,69,222,264,0,0,333,242,91,GAOAOOOAAAXXXXXXXXXXXXGOOAOOOOOAOAOOAXXXXXXXGOAAAAOAXXXXXXXXXXXXXXGOOOOAXXXXXXXXXXXXXXXXGOOAAAXXXXXXXXXXXXXXXXGAAXXXXXXXXXXXXXXXXXXXGOXXXXXXXXXXXXXXXXXXXXGOOOOOAOAAAAXXXXXXXXXXGOOOOOOOOOOAOOOAAAAAAAGAOOAAXXXXXXXXXXXXXXXXGOOAAAXXXXXXXXXXXXXXXXGOOOOOOOAXXXXXXXXXXXXXGOOOAAAAOXXXXXXXXXXXXX,0,0,0
1974,115,45,70,222,263,0,0,333,244,89,GAOAOOOAAAXXXXXXXXXXXXGOOAOOOOOAOAOOAXXXXXXXGOAAAAOAXXXXXXXXXXXXXXGOOOOAXXXXXXXXXXXXXXXXGOOAAAXXXXXXXXXXXXXXXXGAAXXXXXXXXXXXXXXXXXXXGOXXXXXXXXXXXXXXXXXXXXGOOOOOAOAAAAXXXXXXXXXXGOOOOOOOOOOAOOOOAAAAAAGAOOAAXXXXXXXXXXXXXXXXGOOAAAAXXXXXXXXXXXXXXXGOOOOOOOAXXXXXXXXXXXXXGOOOAAAAOXXXXXXXXXXXXX,0,0,0

1995,117,45,72,216,267,0,0,339,246,93,GAOAOOOAAAXXXXXXXXXXXXGOOAOOOOOAOAOOAXXXXXXXGOAAOAOAXXXXXXXXXXXXXXGOOOOAXXXXXXXXXXXXXXXXGOOAAAXXXXXXXXXXXXXXXXGAAAXXXXXXXXXXXXXXXXXXGOXXXXXXXXXXXXXXXXXXXXGOOOOOAOAAAAAXXXXXXXXXGOOOOOOOOOOOOOOOAAAAAAGAOOAAXXXXXXXXXXXXXXXXGOOAAAAXXXXXXXXXXXXXXXGOOOOOOOAXXXXXXXXXXXXXGOOOAAAAOXXXXXXXXXXXXX,0,0,0
2016,117,44,73,216,267,0,0,340,244,96,GOOAOOOAAAXXXXXXXXXXXXGOOAOOOOOAOAOOAXXXXXXXGOAAOAOAXXXXXXXXXXXXXXGOOOOAXXXXXXXXXXXXXXXXGOOAAAXXXXXXXXXXXXXXXXGAAAXXXXXXXXXXXXXXXXXXGOXXXXXXXXXXXXXXXXXXXXGOOOOOAOAAAAAXXXXXXXXXGOOOOOOOOOOOOOOOAAAAAAGAOOAAXXXXXXXXXXXXXXXXGOOAAAAXXXXXXXXXXXXXXXGOOOOOOOAXXXXXXXXXXXXXGOOOAAAAOXXXXXXXXXXXXX,0,0,0
2037,118,43,75,215,267,0,0,342,249,93,GOOOOOOAAAXXXXXXXXXXXXGOOAOOOOOAOAOOAAXXXXXXGOAAOAOAXXXXXXXXXXXXXXGOOOOAXXXXXXXXXXXXXXXXGOOAOAXXXXXXXXXXXXXXXXGAAAXXXXXXXXXXXXXXXXXXGOXXXXXXXXXXXXXXXXXXXXGOOOOOAOAAAAAXXXXXXXXXGOOOOOOOOOOOOOOOAAAAAAGAOOAAXXXXXXXXXXXXXXXXGOOAAAAXXXXXXXXXXXXXXXGOOOOOOOAXXXXXXXXXXXXXGOOOAAAAOXXXXXXXXXXXXX,0,0,0
2058,120,44,76,214,266,0,0,341,247,94,GOOOOOOAAAXXXXXXXXXXXXGOOAOOOOOAOAOOAAXXXXXXGOAAOAOAXXXXXXXXXXXXXXGOOOOOXXXXXXXXXXXXXXXXGOOAOAXXXXXXXXXXXXXXXXGAAAXXXXXXXXXXXXXXXXXXGOAAXXXXXXXXXXXXXXXXXXGOOOOOAOAAAAAXXXXXXXXXGOOOOOOOOOOOOOOOAAAAAAGAOOAAXXXXXXXXXXXXXXXXGOOAAAAXXXXXXXXXXXXXXXGOOOOOOOAXXXXXXXXXXXXXGOOOAAAAOXXXXXXXXXXXXX,0,0,0
2079,120,43,77,212,268,0,0,344,247,97,GOOOOOOAAAXXXXXXXXXXXXGOOAOOOOOOOAOOAAXXXXXXGOAAOAOAXXXXXXXXXXXXXXGOOOOOXXXXXXXXXXXXXXXXGOOAOAXXXXXXXXXXXXXXXXGAAAXXXXXXXXXXXXXXXXXXGOAAXXXXXXXXXXXXXXXXXXGOOOOOAOAAAAAXXXXXXXXXGOOOOOOOOOOOOOOOAAAAAAGAOOAAXXXXXXXXXXXXXXXXGOOAAAAXXXXXXXXXXXXXXXGOOOOOOOAXXXXXXXXXXXXXGOOOAAAAOXXXXXXXXXXXXX,0,0,0

2100,122,45,77,210,268,0,0,345,250,95,GOOOOOOAAAXXXXXXXXXXXXGOOAOOOOOOOAOOAAXXXXXXGOAAOAOAXXXXXXXXXXXXXXGOOOOOAXXXXXXXXXXXXXXXGOOAOAXXXXXXXXXXXXXXXXGAAAXXXXXXXXXXXXXXXXXXGOAAXXXXXXXXXXXXXXXXXXGOOOOOAOAAAAAXXXXXXXXXGOOOOOOOOOOOOOOOAAAAAAGAOOAAXXXXXXXXXXXXXXXXGOOAAAAAXXXXXXXXXXXXXXGOOOOOOOAXXXXXXXXXXXXXGOOOAAAAOXXXXXXXXXXXXX,0,0,0
2121,122,41,81,208,270,0,0,350,246,104,GOOOOOOAAOXXXXXXXXXXXXGOOOOOOOOOOAOOAAXXXXXXGOAAOAOAXXXXXXXXXXXXXXGOOOOOAXXXXXXXXXXXXXXXGOOAOAXXXXXXXXXXXXXXXXGAOAXXXXXXXXXXXXXXXXXXGOAAXXXXXXXXXXXXXXXXXXGOOOOOAOAAAAAXXXXXXXXXGOOOOOOOOOOOOOOOAAAAAAGAOOAAXXXXXXXXXXXXXXXXGOOAAAAAXXXXXXXXXXXXXXGOOOOOOOAXXXXXXXXXXXXXGOOOAAOAOXXXXXXXXXXXXX,0,0,0
2142,125,44,81,209,266,0,0,347,241,106,GOOOOOOAAOAAXXXXXXXXXXGOOOOOOOOOOAOOAAXXXXXXGOAAOAOAAXXXXXXXXXXXXXGOOOOOAXXXXXXXXXXXXXXXGOOAOAXXXXXXXXXXXXXXXXGAOAXXXXXXXXXXXXXXXXXXGOAAXXXXXXXXXXXXXXXXXXGOOOOOAOAAAAAXXXXXXXXXGOOOOOOOOOOOOOOOAAAAAAGAOOAAXXXXXXXXXXXXXXXXGOOAAAAAXXXXXXXXXXXXXXGOOOOOOOAXXXXXXXXXXXXXGOOOAAOAOXXXXXXXXXXXXX,0,0,0
2163,126,44,82,205,269,0,0,351,246,105,GOOOOOOAAOAAXXXXXXXXXXGOOOOOOOOOOAOOAAXXXXXXGOAAOAOAAAXXXXXXXXXXXXGOOOOOAXXXXXXXXXXXXXXXGOOAOAXXXXXXXXXXXXXXXXGAOOXXXXXXXXXXXXXXXXXXGOAAXXXXXXXXXXXXXXXXXXGOOOOOAOAAAAAXXXXXXXXXGOOOOOOOOOOOOOOOAAAAAAGAOOAAXXXXXXXXXXXXXXXXGOOAAAAAXXXXXXXXXXXXXXGOOOOOOOAXXXXXXXXXXXXXGOOOAAOAOXXXXXXXXXXXXX,0,0,0
2184,127,45,82,206,267,0,0,348,248,100,GOOOOOOAAOAAXXXXXXXXXXGOOOOOOOOOOAOOAAXXXXXXGOAAOAOAAAAXXXXXXXXXXXGOOOOOAXXXXXXXXXXXXXXXGOOAOAXXXXXXXXXXXXXXXXGAOOXXXXXXXXXXXXXXXXXXGOAAXXXXXXXXXXXXXXXXXXGOOOOOAOAAAAAXXXXXXXXXGOOOOOOOOOOOOOOOAAAAAAGAOOAAXXXXXXXXXXXXXXXXGOOAAAAAXXXXXXXXXXXXXXGOOOOOOOAXXXXXXXXXXXXXGOOOAAOAOXXXXXXXXXXXXX,0,0,0

2205,130,45,85,205,265,0,0,350,251,99,GOOOOOOAAOAAXXXXXXXXXXGOOOOOOOOOOAOOAAXXXXXXGOAAOAOAAAAXXXXXXXXXXXGOOOOOAXXXXXXXXXXXXXXXGOOOOAAXXXXXXXXXXXXXXXGAOOAXXXXXXXXXXXXXXXXXGOAAXXXXXXXXXXXXXXXXXXGOOOOOAOAAAAAXXXXXXXXXGOOOOOOOOOOOOOOOAOAAAAGAOOAAXXXXXXXXXXXXXXXXGOOAAAAAXXXXXXXXXXXXXXGOOOOOOOOAXXXXXXXXXXXXGOOOAAOAOXXXXXXXXXXXXX,0,0,0
2226,132,47,85,200,268,0,0,353,247,106,GOOOOOOAAOAAXXXXXXXXXXGOOOOOOOOOOAOOAAXXXXXXGOAAOAOAAAAXXXXXXXXXXXGOOOOOAXXXXXXXXXXXXXXXGOOOOAAXXXXXXXXXXXXXXXGAOOAXXXXXXXXXXXXXXXXXGOAAXXXXXXXXXXXXXXXXXXGOOOOOAOAAAAAAXXXXXXXXGOOOOOOOOOOOOOOOAOAAAAGAOOAAAXXXXXXXXXXXXXXXGOOAAAAAXXXXXXXXXXXXXXGOOOOOOOOAXXXXXXXXXXXXGOOOAAOAOXXXXXXXXXXXXX,0,0,0
2247,135,48,87,196,269,0,0,356,247,109,GOOOOOOAAOAAXXXXXXXXXXGOOOOOOOOOOAOOAAAAAXXXGOAAOAOAAAAXXXXXXXXXXXGOOOOOAXXXXXXXXXXXXXXXGOOOOAAXXXXXXXXXXXXXXXGAOOAXXXXXXXXXXXXXXXXXGOAAXXXXXXXXXXXXXXXXXXGOOOOOAOAAAAAAXXXXXXXXGOOOOOOOOOOOOOOOAOAOAAGAOOAAAXXXXXXXXXXXXXXXGOOAAAAAXXXXXXXXXXXXXXGOOOOOOOOAXXXXXXXXXXXXGOOOAAOOOXXXXXXXXXXXXX,0,0,0
2268,137,48,89,195,268,0,0,357,243,114,GOOOOOOAAOAAXXXXXXXXXXGOOOOOOOOOOAOOAAAAOAXXGOAAOAOAAAAXXXXXXXXXXXGOOOOOAXXXXXXXXXXXXXXXGOOOOAAXXXXXXXXXXXXXXXGAOOAXXXXXXXXXXXXXXXXXGOAAXXXXXXXXXXXXXXXXXXGOOOOOAOOAAAAAAXXXXXXXGOOOOOOOOOOOOOOOAOAOAAGAOOAAAXXXXXXXXXXXXXXXGOOAAAAAXXXXXXXXXXXXXXGOOOOOOOOAXXXXXXXXXXXXGOOOAAOOOXXXXXXXXXXXXX,0,0,0
2289,141,52,89,189,270,0,0,359,246,113,GOOOOOOAAOAAXXXXXXXXXXGOOOOOOOOOOAOOAAAAOAAAGOAAOAOAAAAXXXXXXXXXXXGOOOOOAAXXXXXXXXXXXXXXGOOOOAAXXXXXXXXXXXXXXXGAOOAXXXXXXXXXXXXXXXXXGOAAXXXXXXXXXXXXXXXXXXGOOOOOAOOAAAAAAXXXXXXXGOOOOOOOOOOOOOOOAOAOAAGAOOAAAAXXXXXXXXXXXXXXGOOAAAAAXXXXXXXXXXXXXXGOOOOOOOOAXXXXXXXXXXXXGOOOAAOOOXXXXXXXXXXXXX,0,0,0

2310,142,49,93,188,270,0,0,363,256,107,GOOOOOOAAOAAAXXXXXXXXXGOOOOOOOOOOAOOAAAAOAOAGOAAOAOAAAAXXXXXXXXXXXGOOOOOAAXXXXXXXXXXXXXXGOOOOAAXXXXXXXXXXXXXXXGAOOAXXXXXXXXXXXXXXXXXGOAAXXXXXXXXXXXXXXXXXXGOOOOOAOOAAAAAAXXXXXXXGOOOOOOOOOOOOOOOAOOOOAGAOOAAAAXXXXXXXXXXXXXXGOOAAAAAXXXXXXXXXXXXXXGOOOOOOOOAXXXXXXXXXXXXGOOOAOOOOXXXXXXXXXXXXX,0,0,0
2331,142,47,95,190,268,0,0,363,257,106,GOOOOOOAAOAAAXXXXXXXXXGOOOOOOOOOOAOOAAAAOOOAGOAAOAOAAAAXXXXXXXXXXXGOOOOOAAXXXXXXXXXXXXXXGOOOOAAXXXXXXXXXXXXXXXGAOOAXXXXXXXXXXXXXXXXXGOAAXXXXXXXXXXXXXXXXXXGOOOOOAOOOAAAAAXXXXXXXGOOOOOOOOOOOOOOOAOOOOAGAOOAAAAXXXXXXXXXXXXXXGOOAAAAAXXXXXXXXXXXXXXGOOOOOOOOAXXXXXXXXXXXXGOOOAOOOOXXXXXXXXXXXXX,0,0,0
2352,142,46,96,190,268,0,0,364,261,103,GOOOOOOAAOAAAXXXXXXXXXGOOOOOOOOOOAOOAAAAOOOAGOAAOAOAAAAXXXXXXXXXXXGOOOOOAAXXXXXXXXXXXXXXGOOOOAAXXXXXXXXXXXXXXXGAOOAXXXXXXXXXXXXXXXXXGOAAXXXXXXXXXXXXXXXXXXGOOOOOAOOOAAAOAXXXXXXXGOOOOOOOOOOOOOOOAOOOOAGAOOAAAAXXXXXXXXXXXXXXGOOAAAAAXXXXXXXXXXXXXXGOOOOOOOOAXXXXXXXXXXXXGOOOAOOOOXXXXXXXXXXXXX,0,0,0
2373,143,46,97,183,274,0,0,370,264,106,GOOOOOOAAOAAAAXXXXXXXXGOOOOOOOOOOAOOAAAAOOOAGOAAOAOAAAAXXXXXXXXXXXGOOOOOAAXXXXXXXXXXXXXXGOOOOAAXXXXXXXXXXXXXXXGAOOAXXXXXXXXXXXXXXXXXGOAAXXXXXXXXXXXXXXXXXXGOOOOOAOOOAAAOAXXXXXXXGOOOOOOOOOOOOOOOAOOOOAGAOOOAAAXXXXXXXXXXXXXXGOOAAAAAXXXXXXXXXXXXXXGOOOOOOOOAXXXXXXXXXXXXGOOOAOOOOXXXXXXXXXXXXX,0,0,0
2394,143,45,98,187,270,0,0,368,265,103,GOOOOOOAAOAAAAXXXXXXXXGOOOOOOOOOOAOOAAAAOOOAGOAAOAOAAAAXXXXXXXXXXXGOOOOOAAXXXXXXXXXXXXXXGOOOOAAXXXXXXXXXXXXXXXGAOOAXXXXXXXXXXXXXXXXXGOAAXXXXXXXXXXXXXXXXXXGOOOOOAOOOAAAOAXXXXXXXGOOOOOOOOOOOOOOOOOOOOAGAOOOAAAXXXXXXXXXXXXXXGOOAAAAAXXXXXXXXXXXXXXGOOOOOOOOAXXXXXXXXXXXXGOOOAOOOOXXXXXXXXXXXXX,0,0,0

2415,143,42,101,186,271,0,0,372,264,108,GOOOOOOAAOAAAAXXXXXXXXGOOOOOOOOOOAOOAAAAOOOOGOAAOAOAOAAXXXXXXXXXXXGOOOOOAAXXXXXXXXXXXXXXGOOOOAAXXXXXXXXXXXXXXXGAOOAXXXXXXXXXXXXXXXXXGOAAXXXXXXXXXXXXXXXXXXGOOOOOAOOOAAAOAXXXXXXXGOOOOOOOOOOOOOOOOOOOOAGAOOOAAAXXXXXXXXXXXXXXGOOAOAAAXXXXXXXXXXXXXXGOOOOOOOOAXXXXXXXXXXXXGOOOAOOOOXXXXXXXXXXXXX,0,0,0
2436,143,39,104,188,269,0,0,373,261,112,GOOOOOOAOOAAAAXXXXXXXXGOOOOOOOOOOAOOOAAAOOOOGOAAOAOAOAAXXXXXXXXXXXGOOOOOAAXXXXXXXXXXXXXXGOOOOAAXXXXXXXXXXXXXXXGAOOAXXXXXXXXXXXXXXXXXGOAAXXXXXXXXXXXXXXXXXXGOOOOOAOOOAAAOAXXXXXXXGOOOOOOOOOOOOOOOOOOOOAGAOOOAAAXXXXXXXXXXXXXXGOOAOAAAXXXXXXXXXXXXXXGOOOOOOOOAXXXXXXXXXXXXGOOOAOOOOXXXXXXXXXXXXX,0,0,0
2457,145,40,105,187,268,0,0,374,260,114,GOOOOOOAOOAAAAXXXXXXXXGOOOOOOOOOOAOOOAAAOOOOGOOAOAOAOAAXXXXXXXXXXXGOOOOOAAXXXXXXXXXXXXXXGOOOOAAXXXXXXXXXXXXXXXGAOOAXXXXXXXXXXXXXXXXXGOAAXXXXXXXXXXXXXXXXXXGOOOOOAOOOAAAOAXXXXXXXGOOOOOOOOOOOOOOOOOOOOAGAOOOAAAXXXXXXXXXXXXXXGOOAOAAAAXXXXXXXXXXXXXGOOOOOOOOAAXXXXXXXXXXXGOOOAOOOOXXXXXXXXXXXXX,0,0,0
2478,145,39,106,188,267,0,0,374,260,114,GOOOOOOAOOAAAAXXXXXXXXGOOOOOOOOOOOOOOAAAOOOOGOOAOAOAOAAXXXXXXXXXXXGOOOOOAAXXXXXXXXXXXXXXGOOOOAAXXXXXXXXXXXXXXXGAOOAXXXXXXXXXXXXXXXXXGOAAXXXXXXXXXXXXXXXXXXGOOOOOAOOOAAAOAXXXXXXXGOOOOOOOOOOOOOOOOOOOOAGAOOOAAAXXXXXXXXXXXXXXGOOAOAAAAXXXXXXXXXXXXXGOOOOOOOOAAXXXXXXXXXXXGOOOAOOOOXXXXXXXXXXXXX,0,0,0
2499,146,40,106,185,269,0,0,376,268,108,GOOOOOOAOOAAAAXXXXXXXXGOOOOOOOOOOOOOOAAAOOOOGOOAOAOAOAAXXXXXXXXXXXGOOOOOAAXXXXXXXXXXXXXXGOOOOAAXXXXXXXXXXXXXXXGAOOAXXXXXXXXXXXXXXXXXGOAAAXXXXXXXXXXXXXXXXXGOOOOOAOOOAAAOAXXXXXXXGOOOOOOOOOOOOOOOOOOOOAGAOOOAAAXXXXXXXXXXXXXXGOOAOAAAAXXXXXXXXXXXXXGOOOOOOOOAAXXXXXXXXXXXGOOOAOOOOXXXXXXXXXXXXX,0,0,0

2520,146,39,107,187,267,0,0,374,272,102,GOOOOOOAOOAAAAXXXXXXXXGOOOOOOOOOOOOOOAAAOOOOGOOAOAOAOAAXXXXXXXXXXXGOOOOOAAXXXXXXXXXXXXXXGOOOOAAXXXXXXXXXXXXXXXGAOOAXXXXXXXXXXXXXXXXXGOAOAXXXXXXXXXXXXXXXXXGOOOOOAOOOAAAOAXXXXXXXGOOOOOOOOOOOOOOOOOOOOAGAOOOAAAXXXXXXXXXXXXXXGOOAOAAAAXXXXXXXXXXXXXGOOOOOOOOAAXXXXXXXXXXXGOOOAOOOOXXXXXXXXXXXXX,0,0,0
2541,147,36,111,186,267,0,0,379,274,105,GOOOOOOAOOAAAAXXXXXXXXGOOOOOOOOOOOOOOAAAOOOOGOOAOAOAOAOXXXXXXXXXXXGOOOOOOOXXXXXXXXXXXXXXGOOOOAAXXXXXXXXXXXXXXXGAOOAXXXXXXXXXXXXXXXXXGOAOAXXXXXXXXXXXXXXXXXGOOOOOAOOOAAAOAXXXXXXXGOOOOOOOOOOOOOOOOOOOOAGAOOOAOAAXXXXXXXXXXXXXGOOAOAAAAXXXXXXXXXXXXXGOOOOOOOOAAXXXXXXXXXXXGOOOAOOOOXXXXXXXXXXXXX,0,0,0
2562,148,35,113,189,263,0,0,377,277,100,GOOOOOOAOOAAAAXXXXXXXXGOOOOOOOOOOOOOOAAAOOOOGOOAOAOAOAOXXXXXXXXXXXGOOOOOOOXXXXXXXXXXXXXXGOOOOAAXXXXXXXXXXXXXXXGAOOAAXXXXXXXXXXXXXXXXGOAOAXXXXXXXXXXXXXXXXXGOOOOOAOOOAAAOAXXXXXXXGOOOOOOOOOOOOOOOOOOOOAGAOOOAOAAXXXXXXXXXXXXXGOOAOAAAAXXXXXXXXXXXXXGOOOOOOOOOOXXXXXXXXXXXGOOOAOOOOXXXXXXXXXXXXX,0,0,0
2583,149,35,114,186,265,0,0,380,279,101,GOOOOOOAOOAAAAXXXXXXXXGOOOOOOOOOOOOOOAAAOOOOGOOAOAOAOAOXXXXXXXXXXXGOOOOOOOXXXXXXXXXXXXXXGOOOOAAXXXXXXXXXXXXXXXGAOOAAXXXXXXXXXXXXXXXXGOAOAXXXXXXXXXXXXXXXXXGOOOOOAOOOAAAOAXXXXXXXGOOOOOOOOOOOOOOOOOOOOAGAOOOAOAAXXXXXXXXXXXXXGOOAOOAAAAXXXXXXXXXXXXGOOOOOOOOOOXXXXXXXXXXXGOOOAOOOOXXXXXXXXXXXXX,0,0,0
2604,149,34,115,186,265,0,0,381,276,105,GOOOOOOAOOAAAAXXXXXXXXGOOOOOOOOOOOOOOAAAOOOOGOOAOAOAOAOXXXXXXXXXXXGOOOOOOOXXXXXXXXXXXXXXGOOOOAAXXXXXXXXXXXXXXXGAOOAAXXXXXXXXXXXXXXXXGOAOAXXXXXXXXXXXXXXXXXGOOOOOAOOOAAAOAXXXXXXXGOOOOOOOOOOOOOOOOOOOOAGAOOOAOAAXXXXXXXXXXXXXGOOAOOAAOAXXXXXXXXXXXXGOOOOOOOOOOXXXXXXXXXXXGOOOAOOOOXXXXXXXXXXXXX,0,0,0

2625,150,32,118,188,262,0,0,380,269,111,GOOOOOOAOOOAAAXXXXXXXXGOOOOOOOOOOOOOOAAAOOOOGOOAOAOOOAOXXXXXXXXXXXGOOOOOOOXXXXXXXXXXXXXXGOOOOAAXXXXXXXXXXXXXXXGAOOAAAXXXXXXXXXXXXXXXGOAOAXXXXXXXXXXXXXXXXXGOOOOOAOOOAAAOAXXXXXXXGOOOOOOOOOOOOOOOOOOOOAGOOOOAOAAXXXXXXXXXXXXXGOOAOOAAOAXXXXXXXXXXXXGOOOOOOOOOOXXXXXXXXXXXGOOOAOOOOXXXXXXXXXXXXX,0,0,0
2646,151,32,119,193,256,0,0,376,269,107,GOOOOOOAOOOAAAXXXXXXXXGOOOOOOOOOOOOOOAAAOOOOGOOAOAOOOAOXXXXXXXXXXXGOOOOOOOXXXXXXXXXXXXXXGOOOOAAXXXXXXXXXXXXXXXGAOOAAAXXXXXXXXXXXXXXXGOAOAXXXXXXXXXXXXXXXXXGOOOOOAOOOAAAOAXXXXXXXGOOOOOOOOOOOOOOOOOOOOAGOOOOAOOAXXXXXXXXXXXXXGOOAOOAAOAXXXXXXXXXXXXGOOOOOOOOOOXXXXXXXXXXXGOOOAOOOOAXXXXXXXXXXXX,0,0,0
2667,151,30,121,192,257,0,0,379,274,105,GOOOOOOAOOOAAAXXXXXXXXGOOOOOOOOOOOOOOAAAOOOOGOOAOAOOOAOXXXXXXXXXXXGOOOOOOOXXXXXXXXXXXXXXGOOOOAAXXXXXXXXXXXXXXXGAOOAAAXXXXXXXXXXXXXXXGOAOOXXXXXXXXXXXXXXXXXGOOOOOAOOOAAOOAXXXXXXXGOOOOOOOOOOOOOOOOOOOOAGOOOOAOOAXXXXXXXXXXXXXGOOAOOAAOAXXXXXXXXXXXXGOOOOOOOOOOXXXXXXXXXXXGOOOAOOOOAXXXXXXXXXXXX,0,0,0
2688,151,27,124,190,259,0,0,384,279,105,GOOOOOOOOOOAAAXXXXXXXXGOOOOOOOOOOOOOOAOAOOOOGOOAOAOOOAOXXXXXXXXXXXGOOOOOOOXXXXXXXXXXXXXXGOOOOAAXXXXXXXXXXXXXXXGAOOAAAXXXXXXXXXXXXXXXGOAOOXXXXXXXXXXXXXXXXXGOOOOOAOOOAAOOAXXXXXXXGOOOOOOOOOOOOOOOOOOOOAGOOOOAOOAXXXXXXXXXXXXXGOOAOOAAOAXXXXXXXXXXXXGOOOOOOOOOOXXXXXXXXXXXGOOOOOOOOAXXXXXXXXXXXX,0,0,0
2709,151,26,125,190,259,0,0,385,282,103,GOOOOOOOOOOAAAXXXXXXXXGOOOOOOOOOOOOOOAOAOOOOGOOAOAOOOAOXXXXXXXXXXXGOOOOOOOXXXXXXXXXXXXXXGOOOOAAXXXXXXXXXXXXXXXGAOOAOAXXXXXXXXXXXXXXXGOAOOXXXXXXXXXXXXXXXXXGOOOOOAOOOAAOOAXXXXXXXGOOOOOOOOOOOOOOOOOOOOAGOOOOAOOAXXXXXXXXXXXXXGOOAOOAAOAXXXXXXXXXXXXGOOOOOOOOOOXXXXXXXXXXXGOOOOOOOOAXXXXXXXXXXXX,0,0,0

2730,151,26,125,194,255,0,0,381,280,101,GOOOOOOOOOOAAAXXXXXXXXGOOOOOOOOOOOOOOAOAOOOOGOOAOAOOOAOXXXXXXXXXXXGOOOOOOOXXXXXXXXXXXXXXGOOOOAAXXXXXXXXXXXXXXXGAOOAOAXXXXXXXXXXXXXXXGOAOOXXXXXXXXXXXXXXXXXGOOOOOAOOOAAOOAXXXXXXXGOOOOOOOOOOOOOOOOOOOOAGOOOOAOOAXXXXXXXXXXXXXGOOAOOAAOAXXXXXXXXXXXXGOOOOOOOOOOXXXXXXXXXXXGOOOOOOOOAXXXXXXXXXXXX,0,0,0
2751,153,28,125,187,260,0,0,386,286,100,GOOOOOOOOOOAAAXXXXXXXXGOOOOOOOOOOOOOOAOAOOOOGOOAOAOOOAOXXXXXXXXXXXGOOOOOOOAXXXXXXXXXXXXXGOOOOAAXXXXXXXXXXXXXXXGAOOAOAXXXXXXXXXXXXXXXGOAOOAXXXXXXXXXXXXXXXXGOOOOOAOOOAAOOAXXXXXXXGOOOOOOOOOOOOOOOOOOOOAGOOOOAOOAXXXXXXXXXXXXXGOOAOOAAOAXXXXXXXXXXXXGOOOOOOOOOOXXXXXXXXXXXGOOOOOOOOAXXXXXXXXXXXX,0,0,0
2772,153,26,127,189,258,0,0,386,288,98,GOOOOOOOOOOAAAXXXXXXXXGOOOOOOOOOOOOOOAOAOOOOGOOAOAOOOAOXXXXXXXXXXXGOOOOOOOAXXXXXXXXXXXXXGOOOOAOXXXXXXXXXXXXXXXGAOOAOAXXXXXXXXXXXXXXXGOAOOAXXXXXXXXXXXXXXXXGOOOOOAOOOAOOOAXXXXXXXGOOOOOOOOOOOOOOOOOOOOAGOOOOAOOAXXXXXXXXXXXXXGOOAOOAAOAXXXXXXXXXXXXGOOOOOOOOOOXXXXXXXXXXXGOOOOOOOOAXXXXXXXXXXXX,0,0,0
2793,154,27,127,192,254,0,0,382,283,99,GOOOOOOOOOOAAAXXXXXXXXGOOOOOOOOOOOOOOAOAOOOOGOOAOAOOOAOXXXXXXXXXXXGOOOOOOOAXXXXXXXXXXXXXGOOOOAOXXXXXXXXXXXXXXXGAOOAOAXXXXXXXXXXXXXXXGOAOOAAXXXXXXXXXXXXXXXGOOOOOAOOOAOOOAXXXXXXXGOOOOOOOOOOOOOOOOOOOOAGOOOOAOOAXXXXXXXXXXXXXGOOAOOAAOAXXXXXXXXXXXXGOOOOOOOOOOXXXXXXXXXXXGOOOOOOOOAXXXXXXXXXXXX,0,0,0
2814,157,28,129,185,258,0,0,387,288,99,GOOOOOOOOOOOAAAXXXXXXXGOOOOOOOOOOOOOOAOAOOOOGOOAOAOOOAOXXXXXXXXXXXGOOOOOOOAAXXXXXXXXXXXXGOOOOAOXXXXXXXXXXXXXXXGAOOAOAXXXXXXXXXXXXXXXGOAOOAAXXXXXXXXXXXXXXXGOOOOOAOOOOOOOAAXXXXXXGOOOOOOOOOOOOOOOOOOOOAGOOOOAOOAXXXXXXXXXXXXXGOOAOOAAOAXXXXXXXXXXXXGOOOOOOOOOOXXXXXXXXXXXGOOOOOOOOAXXXXXXXXXXXX,0,0,0

2835,157,28,129,184,259,0,0,388,290,98,GOOOOOOOOOOOAAAXXXXXXXGOOOOOOOOOOOOOOAOAOOOOGOOAOAOOOAOXXXXXXXXXXXGOOOOOOOAAXXXXXXXXXXXXGOOOOAOXXXXXXXXXXXXXXXGAOOAOAXXXXXXXXXXXXXXXGOAOOAAXXXXXXXXXXXXXXXGOOOOOAOOOOOOOAAXXXXXXGOOOOOOOOOOOOOOOOOOOOAGOOOOAOOAXXXXXXXXXXXXXGOOAOOAAOAXXXXXXXXXXXXGOOOOOOOOOOXXXXXXXXXXXGOOOOOOOOAXXXXXXXXXXXX,0,0,0
2856,160,31,129,180,260,0,0,389,293,96,GOOOOOOOOOOOAAAXXXXXXXGOOOOOOOOOOOOOOAOAOOOOGOOAOAOOOAOXXXXXXXXXXXGOOOOOOOAAAXXXXXXXXXXXGOOOOAOAXXXXXXXXXXXXXXGAOOAOAXXXXXXXXXXXXXXXGOAOOAAAXXXXXXXXXXXXXXGOOOOOAOOOOOOOAAXXXXXXGOOOOOOOOOOOOOOOOOOOOAGOOOOAOOAXXXXXXXXXXXXXGOOAOOAAOAXXXXXXXXXXXXGOOOOOOOOOOXXXXXXXXXXXGOOOOOOOOAXXXXXXXXXXXX,0,0,0
2877,161,30,131,176,263,0,0,394,297,97,GOOOOOOOOOOOAAAXXXXXXXGOOOOOOOOOOOOOOAOAOOOOGOOAOAOOOAOXXXXXXXXXXXGOOOOOOOAAAXXXXXXXXXXXGOOOOAOAXXXXXXXXXXXXXXGAOOAOAXXXXXXXXXXXXXXXGOOOOAOAXXXXXXXXXXXXXXGOOOOOAOOOOOOOAAXXXXXXGOOOOOOOOOOOOOOOOOOOOAGOOOOAOOAXXXXXXXXXXXXXGOOAOOAAOAXXXXXXXXXXXXGOOOOOOOOOOXXXXXXXXXXXGOOOOOOOOAAXXXXXXXXXXX,0,0,0
2898,161,27,134,181,258,0,0,392,291,101,GOOOOOOOOOOOAAAXXXXXXXGOOOOOOOOOOOOOOAOAOOOOGOOOOAOOOAOXXXXXXXXXXXGOOOOOOOAAAXXXXXXXXXXXGOOOOAOAXXXXXXXXXXXXXXGAOOAOAXXXXXXXXXXXXXXXGOOOOAOAXXXXXXXXXXXXXXGOOOOOAOOOOOOOAOXXXXXXGOOOOOOOOOOOOOOOOOOOOAGOOOOOOOAXXXXXXXXXXXXXGOOAOOAAOAXXXXXXXXXXXXGOOOOOOOOOOXXXXXXXXXXXGOOOOOOOOAAXXXXXXXXXXX,0,0,0
2919,162,26,136,185,253,0,0,389,290,99,GOOOOOOOOOOOAAAXXXXXXXGOOOOOOOOOOOOOOAOAOOOOGOOOOAOOOAOXXXXXXXXXXXGOOOOOOOAAAXXXXXXXXXXXGOOOOAOAXXXXXXXXXXXXXXGOOOAOAXXXXXXXXXXXXXXXGOOOOAOAXXXXXXXXXXXXXXGOOOOOAOOOOOOOAOAXXXXXGOOOOOOOOOOOOOOOOOOOOAGOOOOOOOAXXXXXXXXXXXXXGOOAOOOAOAXXXXXXXXXXXXGOOOOOOOOOOXXXXXXXXXXXGOOOOOOOOAAXXXXXXXXXXX,0,0,0

2940,162,26,136,188,250,0,0,386,292,94,GOOOOOOOOOOOAAAXXXXXXXGOOOOOOOOOOOOOOAOAOOOOGOOOOAOOOAOXXXXXXXXXXXGOOOOOOOAAAXXXXXXXXXXXGOOOOAOAXXXXXXXXXXXXXXGOOOAOAXXXXXXXXXXXXXXXGOOOOAOAXXXXXXXXXXXXXXGOOOOOAOOOOOOOAOAXXXXXGOOOOOOOOOOOOOOOOOOOOAGOOOOOOOAXXXXXXXXXXXXXGOOAOOOAOAXXXXXXXXXXXXGOOOOOOOOOOXXXXXXXXXXXGOOOOOOOOAAXXXXXXXXXXX,0,0,0
2961,163,27,136,194,243,0,0,379,287,92,GOOOOOOOOOOOAAAXXXXXXXGOOOOOOOOOOOOOOAOAOOOOGOOOOAOOOAOXXXXXXXXXXXGOOOOOOOAAAXXXXXXXXXXXGOOOOAOAXXXXXXXXXXXXXXGOOOAOAXXXXXXXXXXXXXXXGOOOOAOAXXXXXXXXXXXXXXGOOOOOAOOOOOOOAOAAXXXXGOOOOOOOOOOOOOOOOOOOOAGOOOOOOOAXXXXXXXXXXXXXGOOAOOOAOAXXXXXXXXXXXXGOOOOOOOOOOXXXXXXXXXXXGOOOOOOOOAAXXXXXXXXXXX,0,0,0
2982,165,27,138,193,242,0,0,380,285,95,GOOOOOOOOOOOAAAAXXXXXXGOOOOOOOOOOOOOOAOAOOOOGOOOOAOOOAOXXXXXXXXXXXGOOOOOOOAAAXXXXXXXXXXXGOOOOAOAXXXXXXXXXXXXXXGOOOAOAAXXXXXXXXXXXXXXGOOOOAOAXXXXXXXXXXXXXXGOOOOOOOOOOOOOAOAAXXXXGOOOOOOOOOOOOOOOOOOOOAGOOOOOOOAXXXXXXXXXXXXXGOOAOOOAOAXXXXXXXXXXXXGOOOOOOOOOOXXXXXXXXXXXGOOOOOOOOAOXXXXXXXXXXX,0,0,0
3003,165,27,138,194,241,0,0,379,284,95,GOOOOOOOOOOOAAAAXXXXXXGOOOOOOOOOOOOOOAOAOOOOGOOOOAOOOAOXXXXXXXXXXXGOOOOOOOAAAXXXXXXXXXXXGOOOOAOAXXXXXXXXXXXXXXGOOOAOAAXXXXXXXXXXXXXXGOOOOAOAXXXXXXXXXXXXXXGOOOOOOOOOOOOOAOAAXXXXGOOOOOOOOOOOOOOOOOOOOAGOOOOOOOAXXXXXXXXXXXXXGOOAOOOAOAXXXXXXXXXXXXGOOOOOOOOOOXXXXXXXXXXXGOOOOOOOOAOXXXXXXXXXXX,0,0,0
3024,166,27,139,193,241,0,0,380,288,92,GOOOOOOOOOOOAAAAAXXXXXGOOOOOOOOOOOOOOAOAOOOOGOOOOAOOOAOXXXXXXXXXXXGOOOOOOOAAAXXXXXXXXXXXGOOOOAOAXXXXXXXXXXXXXXGOOOOOAAXXXXXXXXXXXXXXGOOOOAOAXXXXXXXXXXXXXXGOOOOOOOOOOOOOAOAAXXXXGOOOOOOOOOOOOOOOOOOOOAGOOOOOOOAXXXXXXXXXXXXXGOOAOOOAOAXXXXXXXXXXXXGOOOOOOOOOOXXXXXXXXXXXGOOOOOOOOAOXXXXXXXXXXX,0,0,0

3045,166,27,139,188,246,0,0,384,287,97,GOOOOOOOOOOOAAAAAXXXXXGOOOOOOOOOOOOOOAOAOOOOGOOOOAOOOAOXXXXXXXXXXXGOOOOOOOAAAXXXXXXXXXXXGOOOOAOAXXXXXXXXXXXXXXGOOOOOAAXXXXXXXXXXXXXXGOOOOAOAXXXXXXXXXXXXXXGOOOOOOOOOOOOOAOAAXXXXGOOOOOOOOOOOOOOOOOOOOAGOOOOOOOAXXXXXXXXXXXXXGOOAOOOAOAXXXXXXXXXXXXGOOOOOOOOOOXXXXXXXXXXXGOOOOOOOOAOXXXXXXXXXXX,0,0,0
3066,166,25,141,190,244,0,0,384,293,91,GOOOOOOOOOOOAAAAAXXXXXGOOOOOOOOOOOOOOAOAOOOOGOOOOAOOOAOXXXXXXXXXXXGOOOOOOOAAAXXXXXXXXXXXGOOOOAOAXXXXXXXXXXXXXXGOOOOOOAXXXXXXXXXXXXXXGOOOOAOAXXXXXXXXXXXXXXGOOOOOOOOOOOOOAOAAXXXXGOOOOOOOOOOOOOOOOOOOOAGOOOOOOOAXXXXXXXXXXXXXGOOAOOOAOAXXXXXXXXXXXXGOOOOOOOOOOXXXXXXXXXXXGOOOOOOOOOOXXXXXXXXXXX,0,0,0
3087,169,27,142,193,238,0,0,380,292,88,GOOOOOOOOOOOAAAAAXXXXXGOOOOOOOOOOOOOOAOOOOOOGOOOOAOOOAOXXXXXXXXXXXGOOOOOOOAAAXXXXXXXXXXXGOOOOAOAAXXXXXXXXXXXXXGOOOOOOAXXXXXXXXXXXXXXGOOOOAOAXXXXXXXXXXXXXXGOOOOOOOOOOOOOAOAAAAXXGOOOOOOOOOOOOOOOOOOOOAGOOOOOOOAXXXXXXXXXXXXXGOOAOOOAOAXXXXXXXXXXXXGOOOOOOOOOOXXXXXXXXXXXGOOOOOOOOOOXXXXXXXXXXX,0,0,0
3108,169,27,142,194,237,0,0,379,287,92,GOOOOOOOOOOOAAAAAXXXXXGOOOOOOOOOOOOOOAOOOOOOGOOOOAOOOAOXXXXXXXXXXXGOOOOOOOAAAXXXXXXXXXXXGOOOOAOAAXXXXXXXXXXXXXGOOOOOOAXXXXXXXXXXXXXXGOOOOAOAXXXXXXXXXXXXXXGOOOOOOOOOOOOOAOAAAAXXGOOOOOOOOOOOOOOOOOOOOAGOOOOOOOAXXXXXXXXXXXXXGOOAOOOAOAXXXXXXXXXXXXGOOOOOOOOOOXXXXXXXXXXXGOOOOOOOOOOXXXXXXXXXXX,0,0,0
3129,170,28,142,197,233,0,0,375,286,89,GOOOOOOOOOOOAAAAAAXXXXGOOOOOOOOOOOOOOAOOOOOOGOOOOAOOOAOXXXXXXXXXXXGOOOOOOOAAAXXXXXXXXXXXGOOOOAOAAXXXXXXXXXXXXXGOOOOOOAXXXXXXXXXXXXXXGOOOOAOAXXXXXXXXXXXXXXGOOOOOOOOOOOOOAOAAAAXXGOOOOOOOOOOOOOOOOOOOOAGOOOOOOOAXXXXXXXXXXXXXGOOAOOOAOAXXXXXXXXXXXXGOOOOOOOOOOXXXXXXXXXXXGOOOOOOOOOOXXXXXXXXXXX,0,0,0

3150,171,27,144,195,234,0,0,377,290,87,GOOOOOOOOOOOAAAAAAXXXXGOOOOOOOOOOOOOOAOOOOOOGOOOOAOOOAOXXXXXXXXXXXGOOOOOOOAAAXXXXXXXXXXXGOOOOAOAAXXXXXXXXXXXXXGOOOOOOAXXXXXXXXXXXXXXGOOOOAOAAXXXXXXXXXXXXXGOOOOOOOOOOOOOAOAAAAXXGOOOOOOOOOOOOOOOOOOOOOGOOOOOOOAXXXXXXXXXXXXXGOOAOOOOOAXXXXXXXXXXXXGOOOOOOOOOOXXXXXXXXXXXGOOOOOOOOOOXXXXXXXXXXX,0,0,0
3171,172,27,145,193,235,0,0,380,289,91,GOOOOOOOOOOOAAAAAAXXXXGOOOOOOOOOOOOOOAOOOOOOGOOOOAOOOAOXXXXXXXXXXXGOOOOOOOAAAXXXXXXXXXXXGOOOOAOAAXXXXXXXXXXXXXGOOOOOOAXXXXXXXXXXXXXXGOOOOAOAAXXXXXXXXXXXXXGOOOOOOOOOOOOOAOAAAAXXGOOOOOOOOOOOOOOOOOOOOOGOOOOOOOAXXXXXXXXXXXXXGOOOOOOOOAXXXXXXXXXXXXGOOOOOOOOOOAXXXXXXXXXXGOOOOOOOOOOXXXXXXXXXXX,0,0,0
3192,172,26,146,191,237,0,0,383,289,94,GOOOOOOOOOOOAAAAAAXXXXGOOOOOOOOOOOOOOAOOOOOOGOOOOAOOOAOXXXXXXXXXXXGOOOOOOOAAAXXXXXXXXXXXGOOOOOOAAXXXXXXXXXXXXXGOOOOOOAXXXXXXXXXXXXXXGOOOOAOAAXXXXXXXXXXXXXGOOOOOOOOOOOOOAOAAAAXXGOOOOOOOOOOOOOOOOOOOOOGOOOOOOOAXXXXXXXXXXXXXGOOOOOOOOAXXXXXXXXXXXXGOOOOOOOOOOAXXXXXXXXXXGOOOOOOOOOOXXXXXXXXXXX,0,0,0
3213,172,25,147,192,236,0,0,383,289,94,GOOOOOOOOOOOOAAAAAXXXXGOOOOOOOOOOOOOOAOOOOOOGOOOOAOOOAOXXXXXXXXXXXGOOOOOOOAAAXXXXXXXXXXXGOOOOOOAAXXXXXXXXXXXXXGOOOOOOAXXXXXXXXXXXXXXGOOOOAOAAXXXXXXXXXXXXXGOOOOOOOOOOOOOAOAAAAXXGOOOOOOOOOOOOOOOOOOOOOGOOOOOOOAXXXXXXXXXXXXXGOOOOOOOOAXXXXXXXXXXXXGOOOOOOOOOOAXXXXXXXXXXGOOOOOOOOOOXXXXXXXXXXX,0,0,0
3234,173,24,149,191,236,0,0,384,288,96,GOOOOOOOOOOOOAAAAAXXXXGOOOOOOOOOOOOOOOOOOOOOGOOOOAOOOAOXXXXXXXXXXXGOOOOOOOAAAXXXXXXXXXXXGOOOOOOOAXXXXXXXXXXXXXGOOOOOOAAXXXXXXXXXXXXXGOOOOAOAAXXXXXXXXXXXXXGOOOOOOOOOOOOOAOAAAAXXGOOOOOOOOOOOOOOOOOOOOOGOOOOOOOAXXXXXXXXXXXXXGOOOOOOOOAXXXXXXXXXXXXGOOOOOOOOOOAXXXXXXXXXXGOOOOOOOOOOXXXXXXXXXXX,0,0,0

3255,173,23,150,197,230,0,0,379,288,91,GOOOOOOOOOOOOAAAAAXXXXGOOOOOOOOOOOOOOOOOOOOOGOOOOAOOOAOXXXXXXXXXXXGOOOOOOOAAAXXXXXXXXXXXGOOOOOOOAXXXXXXXXXXXXXGOOOOOOAAXXXXXXXXXXXXXGOOOOAOAAXXXXXXXXXXXXXGOOOOOOOOOOOOOAOAAAAXXGOOOOOOOOOOOOOOOOOOOOOGOOOOOOOOXXXXXXXXXXXXXGOOOOOOOOAXXXXXXXXXXXXGOOOOOOOOOOAXXXXXXXXXXGOOOOOOOOOOXXXXXXXXXXX,0,0,0
3276,175,25,150,200,225,0,0,374,286,88,GOOOOOOOOOOOOAAAAAXXXXGOOOOOOOOOOOOOOOOOOOOOGOOOOAOOOAOXXXXXXXXXXXGOOOOOOOAAAXXXXXXXXXXXGOOOOOOOAXXXXXXXXXXXXXGOOOOOOAAXXXXXXXXXXXXXGOOOOAOAAXXXXXXXXXXXXXGOOOOOOOOOOOOOAOAAAAAAGOOOOOOOOOOOOOOOOOOOOOGOOOOOOOOXXXXXXXXXXXXXGOOOOOOOOAXXXXXXXXXXXXGOOOOOOOOOOAXXXXXXXXXXGOOOOOOOOOOXXXXXXXXXXX,0,0,0
3297,175,24,151,198,227,0,0,377,287,90,GOOOOOOOOOOOOAAAAAXXXXGOOOOOOOOOOOOOOOOOOOOOGOOOOAOOOAOXXXXXXXXXXXGOOOOOOOAAAXXXXXXXXXXXGOOOOOOOAXXXXXXXXXXXXXGOOOOOOAAXXXXXXXXXXXXXGOOOOAOAAXXXXXXXXXXXXXGOOOOOOOOOOOOOAOOAAAAAGOOOOOOOOOOOOOOOOOOOOOGOOOOOOOOXXXXXXXXXXXXXGOOOOOOOOAXXXXXXXXXXXXGOOOOOOOOOOAXXXXXXXXXXGOOOOOOOOOOXXXXXXXXXXX,0,0,0
3318,175,22,153,199,226,0,0,379,290,89,GOOOOOOOOOOOOAAAAAXXXXGOOOOOOOOOOOOOOOOOOOOOGOOOOAOOOAOXXXXXXXXXXXGOOOOOOOAAAXXXXXXXXXXXGOOOOOOOAXXXXXXXXXXXXXGOOOOOOAAXXXXXXXXXXXXXGOOOOAOAAXXXXXXXXXXXXXGOOOOOOOOOOOOOAOOAAOAOGOOOOOOOOOOOOOOOOOOOOOGOOOOOOOOXXXXXXXXXXXXXGOOOOOOOOAXXXXXXXXXXXXGOOOOOOOOOOAXXXXXXXXXXGOOOOOOOOOOXXXXXXXXXXX,0,0,0
3339,176,23,153,197,227,0,0,380,291,89,GOOOOOOOOOOOOAAAAAAXXXGOOOOOOOOOOOOOOOOOOOOOGOOOOAOOOAOXXXXXXXXXXXGOOOOOOOAAAXXXXXXXXXXXGOOOOOOOAXXXXXXXXXXXXXGOOOOOOAAXXXXXXXXXXXXXGOOOOAOAAXXXXXXXXXXXXXGOOOOOOOOOOOOOAOOAAOAOGOOOOOOOOOOOOOOOOOOOOOGOOOOOOOOXXXXXXXXXXXXXGOOOOOOOOAXXXXXXXXXXXXGOOOOOOOOOOAXXXXXXXXXXGOOOOOOOOOOXXXXXXXXXXX,0,0,0

3360,176,23,153,195,229,0,0,382,291,91,GOOOOOOOOOOOOAAAAAAXXXGOOOOOOOOOOOOOOOOOOOOOGOOOOAOOOAOXXXXXXXXXXXGOOOOOOOAAAXXXXXXXXXXXGOOOOOOOAXXXXXXXXXXXXXGOOOOOOAAXXXXXXXXXXXXXGOOOOAOAAXXXXXXXXXXXXXGOOOOOOOOOOOOOAOOAAOAOGOOOOOOOOOOOOOOOOOOOOOGOOOOOOOOXXXXXXXXXXXXXGOOOOOOOOAXXXXXXXXXXXXGOOOOOOOOOOAXXXXXXXXXXGOOOOOOOOOOXXXXXXXXXXX,0,0,0
3381,176,23,153,197,227,0,0,380,288,92,GOOOOOOOOOOOOAAAAAAXXXGOOOOOOOOOOOOOOOOOOOOOGOOOOAOOOAOXXXXXXXXXXXGOOOOOOOAAAXXXXXXXXXXXGOOOOOOOAXXXXXXXXXXXXXGOOOOOOAAXXXXXXXXXXXXXGOOOOAOAAXXXXXXXXXXXXXGOOOOOOOOOOOOOAOOAAOAOGOOOOOOOOOOOOOOOOOOOOOGOOOOOOOOXXXXXXXXXXXXXGOOOOOOOOAXXXXXXXXXXXXGOOOOOOOOOOAXXXXXXXXXXGOOOOOOOOOOXXXXXXXXXXX,0,0,0
3402,176,21,155,198,226,0,0,381,293,88,GOOOOOOOOOOOOAAOAAAXXXGOOOOOOOOOOOOOOOOOOOOOGOOOOAOOOAOXXXXXXXXXXXGOOOOOOOAAAXXXXXXXXXXXGOOOOOOOAXXXXXXXXXXXXXGOOOOOOOAXXXXXXXXXXXXXGOOOOAOAAXXXXXXXXXXXXXGOOOOOOOOOOOOOAOOAAOAOGOOOOOOOOOOOOOOOOOOOOOGOOOOOOOOXXXXXXXXXXXXXGOOOOOOOOAXXXXXXXXXXXXGOOOOOOOOOOAXXXXXXXXXXGOOOOOOOOOOXXXXXXXXXXX,0,0,0
3423,176,19,157,198,226,0,0,382,291,91,GOOOOOOOOOOOOAOOAAAXXXGOOOOOOOOOOOOOOOOOOOOOGOOOOAOOOAOXXXXXXXXXXXGOOOOOOOAAAXXXXXXXXXXXGOOOOOOOOXXXXXXXXXXXXXGOOOOOOOAXXXXXXXXXXXXXGOOOOAOAAXXXXXXXXXXXXXGOOOOOOOOOOOOOAOOAAOAOGOOOOOOOOOOOOOOOOOOOOOGOOOOOOOOXXXXXXXXXXXXXGOOOOOOOOAXXXXXXXXXXXXGOOOOOOOOOOAXXXXXXXXXXGOOOOOOOOOOXXXXXXXXXXX,0,0,0
3444,176,19,157,194,230,0,0,386,290,96,GOOOOOOOOOOOOAOOAAAXXXGOOOOOOOOOOOOOOOOOOOOOGOOOOAOOOAOXXXXXXXXXXXGOOOOOOOAAAXXXXXXXXXXXGOOOOOOOOXXXXXXXXXXXXXGOOOOOOOAXXXXXXXXXXXXXGOOOOAOAAXXXXXXXXXXXXXGOOOOOOOOOOOOOAOOAAOAOGOOOOOOOOOOOOOOOOOOOOOGOOOOOOOOXXXXXXXXXXXXXGOOOOOOOOAXXXXXXXXXXXXGOOOOOOOOOOAXXXXXXXXXXGOOOOOOOOOOXXXXXXXXXXX,0,0,0

3465,177,20,157,192,231,0,0,388,289,99,GOOOOOOOOOOOOAOOAAAXXXGOOOOOOOOOOOOOOOOOOOOOGOOOOAOOOAOXXXXXXXXXXXGOOOOOOOAAAXXXXXXXXXXXGOOOOOOOOAXXXXXXXXXXXXGOOOOOOOAXXXXXXXXXXXXXGOOOOAOAAXXXXXXXXXXXXXGOOOOOOOOOOOOOAOOAAOAOGOOOOOOOOOOOOOOOOOOOOOGOOOOOOOOXXXXXXXXXXXXXGOOOOOOOOAXXXXXXXXXXXXGOOOOOOOOOOAXXXXXXXXXXGOOOOOOOOOOXXXXXXXXXXX,0,0,0
3486,178,20,158,191,231,0,0,389,295,94,GOOOOOOOOOOOOAOOAOAXXXGOOOOOOOOOOOOOOOOOOOOOGOOOOAOOOAOXXXXXXXXXXXGOOOOOOOAAAXXXXXXXXXXXGOOOOOOOOAXXXXXXXXXXXXGOOOOOOOAXXXXXXXXXXXXXGOOOOAOAAXXXXXXXXXXXXXGOOOOOOOOOOOOOAOOAAOAOGOOOOOOOOOOOOOOOOOOOOOGOOOOOOOOXXXXXXXXXXXXXGOOOOOOOOAXXXXXXXXXXXXGOOOOOOOOOOAAXXXXXXXXXGOOOOOOOOOOXXXXXXXXXXX,0,0,0
3507,178,17,161,195,227,0,0,388,296,92,GOOOOOOOOOOOOOOOAOAXXXGOOOOOOOOOOOOOOOOOOOOOGOOOOAOOOAOXXXXXXXXXXXGOOOOOOOOAAXXXXXXXXXXXGOOOOOOOOAXXXXXXXXXXXXGOOOOOOOAXXXXXXXXXXXXXGOOOOAOAAXXXXXXXXXXXXXGOOOOOOOOOOOOOAOOAAOAOGOOOOOOOOOOOOOOOOOOOOOGOOOOOOOOXXXXXXXXXXXXXGOOOOOOOOAXXXXXXXXXXXXGOOOOOOOOOOAOXXXXXXXXXGOOOOOOOOOOXXXXXXXXXXX,0,0,0
3528,178,16,162,199,223,0,0,385,293,92,GOOOOOOOOOOOOOOOAOAXXXGOOOOOOOOOOOOOOOOOOOOOGOOOOAOOOAOXXXXXXXXXXXGOOOOOOOOAAXXXXXXXXXXXGOOOOOOOOAXXXXXXXXXXXXGOOOOOOOAXXXXXXXXXXXXXGOOOOAOAAXXXXXXXXXXXXXGOOOOOOOOOOOOOAOOOAOAOGOOOOOOOOOOOOOOOOOOOOOGOOOOOOOOXXXXXXXXXXXXXGOOOOOOOOAXXXXXXXXXXXXGOOOOOOOOOOAOXXXXXXXXXGOOOOOOOOOOXXXXXXXXXXX,0,0,0
3549,179,17,162,197,224,0,0,385,296,89,GOOOOOOOOOOOOOOOAOAAXXGOOOOOOOOOOOOOOOOOOOOOGOOOOAOOOAOXXXXXXXXXXXGOOOOOOOOAAXXXXXXXXXXXGOOOOOOOOAXXXXXXXXXXXXGOOOOOOOAXXXXXXXXXXXXXGOOOOAOAAXXXXXXXXXXXXXGOOOOOOOOOOOOOAOOOAOAOGOOOOOOOOOOOOOOOOOOOOOGOOOOOOOOXXXXXXXXXXXXXGOOOOOOOOAXXXXXXXXXXXXGOOOOOOOOOOAOXXXXXXXXXGOOOOOOOOOOXXXXXXXXXXX,0,0,0

3570,179,17,162,201,220,0,0,383,295,88,GOOOOOOOOOOOOOOOAOAAXXGOOOOOOOOOOOOOOOOOOOOOGOOOOAOOOAOXXXXXXXXXXXGOOOOOOOOAAXXXXXXXXXXXGOOOOOOOOAXXXXXXXXXXXXGOOOOOOOAXXXXXXXXXXXXXGOOOOAOAAXXXXXXXXXXXXXGOOOOOOOOOOOOOAOOOAOAOGOOOOOOOOOOOOOOOOOOOOOGOOOOOOOOXXXXXXXXXXXXXGOOOOOOOOAXXXXXXXXXXXXGOOOOOOOOOOAOXXXXXXXXXGOOOOOOOOOOXXXXXXXXXXX,0,0,0
3591,181,19,162,194,225,0,0,388,298,90,GOOOOOOOOOOOOOOOAOAAAAGOOOOOOOOOOOOOOOOOOOOOGOOOOAOOOAOXXXXXXXXXXXGOOOOOOOOAAXXXXXXXXXXXGOOOOOOOOAXXXXXXXXXXXXGOOOOOOOAXXXXXXXXXXXXXGOOOOAOAAXXXXXXXXXXXXXGOOOOOOOOOOOOOAOOOAOAOGOOOOOOOOOOOOOOOOOOOOOGOOOOOOOOXXXXXXXXXXXXXGOOOOOOOOAXXXXXXXXXXXXGOOOOOOOOOOAOXXXXXXXXXGOOOOOOOOOOXXXXXXXXXXX,0,0,0
3612,181,18,163,192,227,0,0,392,306,86,GOOOOOOOOOOOOOOOAOAAAAGOOOOOOOOOOOOOOOOOOOOOGOOOOAOOOAOXXXXXXXXXXXGOOOOOOOOAAXXXXXXXXXXXGOOOOOOOOAXXXXXXXXXXXXGOOOOOOOAXXXXXXXXXXXXXGOOOOAOAAXXXXXXXXXXXXXGOOOOOOOOOOOOOAOOOAOAOGOOOOOOOOOOOOOOOOOOOOOGOOOOOOOOXXXXXXXXXXXXXGOOOOOOOOAXXXXXXXXXXXXGOOOOOOOOOOOOXXXXXXXXXGOOOOOOOOOOXXXXXXXXXXX,0,0,0
3633,181,17,164,191,228,0,0,394,306,88,GOOOOOOOOOOOOOOOAOAAAAGOOOOOOOOOOOOOOOOOOOOOGOOOOAOOOAOXXXXXXXXXXXGOOOOOOOOAAXXXXXXXXXXXGOOOOOOOOAXXXXXXXXXXXXGOOOOOOOAXXXXXXXXXXXXXGOOOOAOAAXXXXXXXXXXXXXGOOOOOOOOOOOOOAOOOAOAOGOOOOOOOOOOOOOOOOOOOOOGOOOOOOOOXXXXXXXXXXXXXGOOOOOOOOOXXXXXXXXXXXXGOOOOOOOOOOOOXXXXXXXXXGOOOOOOOOOOXXXXXXXXXXX,0,0,0
3654,181,16,165,196,223,0,0,390,302,88,GOOOOOOOOOOOOOOOAOAAAAGOOOOOOOOOOOOOOOOOOOOOGOOOOOOOOAOXXXXXXXXXXXGOOOOOOOOAAXXXXXXXXXXXGOOOOOOOOAXXXXXXXXXXXXGOOOOOOOAXXXXXXXXXXXXXGOOOOAOAAXXXXXXXXXXXXXGOOOOOOOOOOOOOAOOOAOAOGOOOOOOOOOOOOOOOOOOOOOGOOOOOOOOXXXXXXXXXXXXXGOOOOOOOOOXXXXXXXXXXXXGOOOOOOOOOOOOXXXXXXXXXGOOOOOOOOOOXXXXXXXXXXX,0,0,0

3675,181,14,167,194,225,0,0,394,299,95,GOOOOOOOOOOOOOOOAOAAAAGOOOOOOOOOOOOOOOOOOOOOGOOOOOOOOOOXXXXXXXXXXXGOOOOOOOOAAXXXXXXXXXXXGOOOOOOOOAXXXXXXXXXXXXGOOOOOOOAXXXXXXXXXXXXXGOOOOAOAAXXXXXXXXXXXXXGOOOOOOOOOOOOOOOOOAOAOGOOOOOOOOOOOOOOOOOOOOOGOOOOOOOOXXXXXXXXXXXXXGOOOOOOOOOXXXXXXXXXXXXGOOOOOOOOOOOOXXXXXXXXXGOOOOOOOOOOXXXXXXXXXXX,0,0,0
3696,182,14,168,192,226,0,0,396,302,94,GOOOOOOOOOOOOOOOAOAAAAGOOOOOOOOOOOOOOOOOOOOOGOOOOOOOOOOXXXXXXXXXXXGOOOOOOOOAAXXXXXXXXXXXGOOOOOOOOAXXXXXXXXXXXXGOOOOOOOOXXXXXXXXXXXXXGOOOOAOAAAXXXXXXXXXXXXGOOOOOOOOOOOOOOOOOAOAOGOOOOOOOOOOOOOOOOOOOOOGOOOOOOOOXXXXXXXXXXXXXGOOOOOOOOOXXXXXXXXXXXXGOOOOOOOOOOOOXXXXXXXXXGOOOOOOOOOOXXXXXXXXXXX,0,0,0
3717,182,14,168,192,226,0,0,396,305,91,GOOOOOOOOOOOOOOOAOAAAAGOOOOOOOOOOOOOOOOOOOOOGOOOOOOOOOOXXXXXXXXXXXGOOOOOOOOAAXXXXXXXXXXXGOOOOOOOOAXXXXXXXXXXXXGOOOOOOOOXXXXXXXXXXXXXGOOOOAOAAAXXXXXXXXXXXXGOOOOOOOOOOOOOOOOOAOAOGOOOOOOOOOOOOOOOOOOOOOGOOOOOOOOXXXXXXXXXXXXXGOOOOOOOOOXXXXXXXXXXXXGOOOOOOOOOOOOXXXXXXXXXGOOOOOOOOOOXXXXXXXXXXX,0,0,0
3738,182,13,169,188,230,0,0,399,305,94,GOOOOOOOOOOOOOOOAOAAAAGOOOOOOOOOOOOOOOOOOOOOGOOOOOOOOOOXXXXXXXXXXXGOOOOOOOOAAXXXXXXXXXXXGOOOOOOOOAXXXXXXXXXXXXGOOOOOOOOXXXXXXXXXXXXXGOOOOAOOAAXXXXXXXXXXXXGOOOOOOOOOOOOOOOOOAOAOGOOOOOOOOOOOOOOOOOOOOOGOOOOOOOOXXXXXXXXXXXXXGOOOOOOOOOXXXXXXXXXXXXGOOOOOOOOOOOOXXXXXXXXXGOOOOOOOOOOXXXXXXXXXXX,0,0,0
3759,182,12,170,183,235,0,0,407,307,100,GOOOOOOOOOOOOOOOAOAAAAGOOOOOOOOOOOOOOOOOOOOOGOOOOOOOOOOXXXXXXXXXXXGOOOOOOOOAAXXXXXXXXXXXGOOOOOOOOOXXXXXXXXXXXXGOOOOOOOOXXXXXXXXXXXXXGOOOOAOOAAXXXXXXXXXXXXGOOOOOOOOOOOOOOOOOAOAOGOOOOOOOOOOOOOOOOOOOOOGOOOOOOOOXXXXXXXXXXXXXGOOOOOOOOOXXXXXXXXXXXXGOOOOOOOOOOOOXXXXXXXXXGOOOOOOOOOOXXXXXXXXXXX,0,0,0

3780,182,11,171,181,237,0,0,410,305,105,GOOOOOOOOOOOOOOOAOAAAAGOOOOOOOOOOOOOOOOOOOOOGOOOOOOOOOOXXXXXXXXXXXGOOOOOOOOOAXXXXXXXXXXXGOOOOOOOOOXXXXXXXXXXXXGOOOOOOOOXXXXXXXXXXXXXGOOOOAOOAAXXXXXXXXXXXXGOOOOOOOOOOOOOOOOOAOAOGOOOOOOOOOOOOOOOOOOOOOGOOOOOOOOXXXXXXXXXXXXXGOOOOOOOOOXXXXXXXXXXXXGOOOOOOOOOOOOXXXXXXXXXGOOOOOOOOOOXXXXXXXXXXX,0,0,0
3801,182,11,171,182,236,0,0,409,305,104,GOOOOOOOOOOOOOOOAOAAAAGOOOOOOOOOOOOOOOOOOOOOGOOOOOOOOOOXXXXXXXXXXXGOOOOOOOOOAXXXXXXXXXXXGOOOOOOOOOXXXXXXXXXXXXGOOOOOOOOXXXXXXXXXXXXXGOOOOAOOAAXXXXXXXXXXXXGOOOOOOOOOOOOOOOOOAOAOGOOOOOOOOOOOOOOOOOOOOOGOOOOOOOOXXXXXXXXXXXXXGOOOOOOOOOXXXXXXXXXXXXGOOOOOOOOOOOOXXXXXXXXXGOOOOOOOOOOXXXXXXXXXXX,0,0,0
3822,183,11,172,175,242,0,0,415,309,106,GOOOOOOOOOOOOOOOAOAAAAGOOOOOOOOOOOOOOOOOOOOOGOOOOOOOOOOXXXXXXXXXXXGOOOOOOOOOAXXXXXXXXXXXGOOOOOOOOOXXXXXXXXXXXXGOOOOOOOOXXXXXXXXXXXXXGOOOOAOOAAAXXXXXXXXXXXGOOOOOOOOOOOOOOOOOOOAOGOOOOOOOOOOOOOOOOOOOOOGOOOOOOOOXXXXXXXXXXXXXGOOOOOOOOOXXXXXXXXXXXXGOOOOOOOOOOOOXXXXXXXXXGOOOOOOOOOOXXXXXXXXXXX,0,0,0
3843,184,12,172,173,243,0,0,417,312,105,GOOOOOOOOOOOOOOOAOAAAAGOOOOOOOOOOOOOOOOOOOOOGOOOOOOOOOOXXXXXXXXXXXGOOOOOOOOOAXXXXXXXXXXXGOOOOOOOOOAXXXXXXXXXXXGOOOOOOOOXXXXXXXXXXXXXGOOOOAOOAAAXXXXXXXXXXXGOOOOOOOOOOOOOOOOOOOAOGOOOOOOOOOOOOOOOOOOOOOGOOOOOOOOXXXXXXXXXXXXXGOOOOOOOOOXXXXXXXXXXXXGOOOOOOOOOOOOXXXXXXXXXGOOOOOOOOOOXXXXXXXXXXX,0,0,0
3864,184,11,173,172,244,0,0,418,309,109,GOOOOOOOOOOOOOOOAOAAAAGOOOOOOOOOOOOOOOOOOOOOGOOOOOOOOOOXXXXXXXXXXXGOOOOOOOOOAXXXXXXXXXXXGOOOOOOOOOAXXXXXXXXXXXGOOOOOOOOXXXXXXXXXXXXXGOOOOAOOAAOXXXXXXXXXXXGOOOOOOOOOOOOOOOOOOOAOGOOOOOOOOOOOOOOOOOOOOOGOOOOOOOOXXXXXXXXXXXXXGOOOOOOOOOXXXXXXXXXXXXGOOOOOOOOOOOOXXXXXXXXXGOOOOOOOOOOXXXXXXXXXXX,0,0,0

3885,184,11,173,174,242,0,0,416,314,102,GOOOOOOOOOOOOOOOAOAAAAGOOOOOOOOOOOOOOOOOOOOOGOOOOOOOOOOXXXXXXXXXXXGOOOOOOOOOAXXXXXXXXXXXGOOOOOOOOOAXXXXXXXXXXXGOOOOOOOOXXXXXXXXXXXXXGOOOOAOOAAOXXXXXXXXXXXGOOOOOOOOOOOOOOOOOOOAOGOOOOOOOOOOOOOOOOOOOOOGOOOOOOOOXXXXXXXXXXXXXGOOOOOOOOOXXXXXXXXXXXXGOOOOOOOOOOOOXXXXXXXXXGOOOOOOOOOOXXXXXXXXXXX,0,0,0
3906,184,10,174,176,240,0,0,415,313,102,GOOOOOOOOOOOOOOOAOAAAAGOOOOOOOOOOOOOOOOOOOOOGOOOOOOOOOOXXXXXXXXXXXGOOOOOOOOOAXXXXXXXXXXXGOOOOOOOOOAXXXXXXXXXXXGOOOOOOOOXXXXXXXXXXXXXGOOOOOOOAAOXXXXXXXXXXXGOOOOOOOOOOOOOOOOOOOAOGOOOOOOOOOOOOOOOOOOOOOGOOOOOOOOXXXXXXXXXXXXXGOOOOOOOOOXXXXXXXXXXXXGOOOOOOOOOOOOXXXXXXXXXGOOOOOOOOOOXXXXXXXXXXX,0,0,0
3927,184,10,174,177,239,0,0,414,318,96,GOOOOOOOOOOOOOOOAOAAAAGOOOOOOOOOOOOOOOOOOOOOGOOOOOOOOOOXXXXXXXXXXXGOOOOOOOOOAXXXXXXXXXXXGOOOOOOOOOAXXXXXXXXXXXGOOOOOOOOXXXXXXXXXXXXXGOOOOOOOAAOXXXXXXXXXXXGOOOOOOOOOOOOOOOOOOOAOGOOOOOOOOOOOOOOOOOOOOOGOOOOOOOOXXXXXXXXXXXXXGOOOOOOOOOXXXXXXXXXXXXGOOOOOOOOOOOOXXXXXXXXXGOOOOOOOOOOXXXXXXXXXXX,0,0,0
3948,184,9,175,178,238,0,0,414,320,94,GOOOOOOOOOOOOOOOOOAAAAGOOOOOOOOOOOOOOOOOOOOOGOOOOOOOOOOXXXXXXXXXXXGOOOOOOOOOAXXXXXXXXXXXGOOOOOOOOOAXXXXXXXXXXXGOOOOOOOOXXXXXXXXXXXXXGOOOOOOOAAOXXXXXXXXXXXGOOOOOOOOOOOOOOOOOOOAOGOOOOOOOOOOOOOOOOOOOOOGOOOOOOOOXXXXXXXXXXXXXGOOOOOOOOOXXXXXXXXXXXXGOOOOOOOOOOOOXXXXXXXXXGOOOOOOOOOOXXXXXXXXXXX,0,0,0
3969,185,10,175,177,238,0,0,414,321,93,GOOOOOOOOOOOOOOOOOAAAAGOOOOOOOOOOOOOOOOOOOOOGOOOOOOOOOOXXXXXXXXXXXGOOOOOOOOOAXXXXXXXXXXXGOOOOOOOOOAXXXXXXXXXXXGOOOOOOOOXXXXXXXXXXXXXGOOOOOOOAAOXXXXXXXXXXXGOOOOOOOOOOOOOOOOOOOAOGOOOOOOOOOOOOOOOOOOOOOGOOOOOOOOAXXXXXXXXXXXXGOOOOOOOOOXXXXXXXXXXXXGOOOOOOOOOOOOXXXXXXXXXGOOOOOOOOOOXXXXXXXXXXX,0,0,0

3990,187,12,175,175,238,0,0,414,322,92,GOOOOOOOOOOOOOOOOOAAAAGOOOOOOOOOOOOOOOOOOOOOGOOOOOOOOOOXXXXXXXXXXXGOOOOOOOOOAXXXXXXXXXXXGOOOOOOOOOAXXXXXXXXXXXGOOOOOOOOAXXXXXXXXXXXXGOOOOOOOAAOXXXXXXXXXXXGOOOOOOOOOOOOOOOOOOOAOGOOOOOOOOOOOOOOOOOOOOOGOOOOOOOOAXXXXXXXXXXXXGOOOOOOOOOXXXXXXXXXXXXGOOOOOOOOOOOOAXXXXXXXXGOOOOOOOOOOXXXXXXXXXXX,0,0,0
4011,187,10,177,172,241,0,0,419,325,94,GOOOOOOOOOOOOOOOOOOAAOGOOOOOOOOOOOOOOOOOOOOOGOOOOOOOOOOXXXXXXXXXXXGOOOOOOOOOAXXXXXXXXXXXGOOOOOOOOOAXXXXXXXXXXXGOOOOOOOOAXXXXXXXXXXXXGOOOOOOOAAOXXXXXXXXXXXGOOOOOOOOOOOOOOOOOOOAOGOOOOOOOOOOOOOOOOOOOOOGOOOOOOOOAXXXXXXXXXXXXGOOOOOOOOOXXXXXXXXXXXXGOOOOOOOOOOOOAXXXXXXXXGOOOOOOOOOOXXXXXXXXXXX,0,0,0
4032,187,10,177,173,240,0,0,418,325,93,GOOOOOOOOOOOOOOOOOOAAOGOOOOOOOOOOOOOOOOOOOOOGOOOOOOOOOOXXXXXXXXXXXGOOOOOOOOOAXXXXXXXXXXXGOOOOOOOOOAXXXXXXXXXXXGOOOOOOOOAXXXXXXXXXXXXGOOOOOOOAAOXXXXXXXXXXXGOOOOOOOOOOOOOOOOOOOAOGOOOOOOOOOOOOOOOOOOOOOGOOOOOOOOAXXXXXXXXXXXXGOOOOOOOOOXXXXXXXXXXXXGOOOOOOOOOOOOAXXXXXXXXGOOOOOOOOOOXXXXXXXXXXX,0,0,0
4053,187,9,178,178,235,0,0,414,328,86,GOOOOOOOOOOOOOOOOOOAAOGOOOOOOOOOOOOOOOOOOOOOGOOOOOOOOOOXXXXXXXXXXXGOOOOOOOOOOXXXXXXXXXXXGOOOOOOOOOAXXXXXXXXXXXGOOOOOOOOAXXXXXXXXXXXXGOOOOOOOAAOXXXXXXXXXXXGOOOOOOOOOOOOOOOOOOOAOGOOOOOOOOOOOOOOOOOOOOOGOOOOOOOOAXXXXXXXXXXXXGOOOOOOOOOXXXXXXXXXXXXGOOOOOOOOOOOOAXXXXXXXXGOOOOOOOOOOXXXXXXXXXXX,0,0,0
4074,187,9,178,175,238,0,0,416,332,84,GOOOOOOOOOOOOOOOOOOAAOGOOOOOOOOOOOOOOOOOOOOOGOOOOOOOOOOXXXXXXXXXXXGOOOOOOOOOOXXXXXXXXXXXGOOOOOOOOOAXXXXXXXXXXXGOOOOOOOOAXXXXXXXXXXXXGOOOOOOOAAOXXXXXXXXXXXGOOOOOOOOOOOOOOOOOOOAOGOOOOOOOOOOOOOOOOOOOOOGOOOOOOOOAXXXXXXXXXXXXGOOOOOOOOOXXXXXXXXXXXXGOOOOOOOOOOOOAXXXXXXXXGOOOOOOOOOOXXXXXXXXXXX,0,0,0

4095,188,10,178,182,230,0,0,409,328,81,GOOOOOOOOOOOOOOOOOOAAOGOOOOOOOOOOOOOOOOOOOOOGOOOOOOOOOOXXXXXXXXXXXGOOOOOOOOOOXXXXXXXXXXXGOOOOOOOOOAXXXXXXXXXXXGOOOOOOOOAAXXXXXXXXXXXGOOOOOOOAAOXXXXXXXXXXXGOOOOOOOOOOOOOOOOOOOAOGOOOOOOOOOOOOOOOOOOOOOGOOOOOOOOAXXXXXXXXXXXXGOOOOOOOOOXXXXXXXXXXXXGOOOOOOOOOOOOAXXXXXXXXGOOOOOOOOOOXXXXXXXXXXX,0,0,0
4116,188,10,178,182,230,0,0,409,329,80,GOOOOOOOOOOOOOOOOOOAAOGOOOOOOOOOOOOOOOOOOOOOGOOOOOOOOOOXXXXXXXXXXXGOOOOOOOOOOXXXXXXXXXXXGOOOOOOOOOAXXXXXXXXXXXGOOOOOOOOAAXXXXXXXXXXXGOOOOOOOAAOXXXXXXXXXXXGOOOOOOOOOOOOOOOOOOOAOGOOOOOOOOOOOOOOOOOOOOOGOOOOOOOOAXXXXXXXXXXXXGOOOOOOOOOXXXXXXXXXXXXGOOOOOOOOOOOOAXXXXXXXXGOOOOOOOOOOXXXXXXXXXXX,0,0,0
4137,188,10,178,178,234,0,0,413,330,83,GOOOOOOOOOOOOOOOOOOAAOGOOOOOOOOOOOOOOOOOOOOOGOOOOOOOOOOXXXXXXXXXXXGOOOOOOOOOOXXXXXXXXXXXGOOOOOOOOOAXXXXXXXXXXXGOOOOOOOOAAXXXXXXXXXXXGOOOOOOOAAOXXXXXXXXXXXGOOOOOOOOOOOOOOOOOOOAOGOOOOOOOOOOOOOOOOOOOOOGOOOOOOOOAXXXXXXXXXXXXGOOOOOOOOOXXXXXXXXXXXXGOOOOOOOOOOOOAXXXXXXXXGOOOOOOOOOOXXXXXXXXXXX,0,0,0
4158,188,10,178,177,235,0,0,414,331,83,GOOOOOOOOOOOOOOOOOOAAOGOOOOOOOOOOOOOOOOOOOOOGOOOOOOOOOOXXXXXXXXXXXGOOOOOOOOOOXXXXXXXXXXXGOOOOOOOOOAXXXXXXXXXXXGOOOOOOOOAAXXXXXXXXXXXGOOOOOOOAAOXXXXXXXXXXXGOOOOOOOOOOOOOOOOOOOAOGOOOOOOOOOOOOOOOOOOOOOGOOOOOOOOAXXXXXXXXXXXXGOOOOOOOOOXXXXXXXXXXXXGOOOOOOOOOOOOAXXXXXXXXGOOOOOOOOOOXXXXXXXXXXX,0,0,0
4179,189,11,178,171,240,0,0,419,333,86,GOOOOOOOOOOOOOOOOOOAAOGOOOOOOOOOOOOOOOOOOOOOGOOOOOOOOOOXXXXXXXXXXXGOOOOOOOOOOAXXXXXXXXXXGOOOOOOOOOAXXXXXXXXXXXGOOOOOOOOAAXXXXXXXXXXXGOOOOOOOAAOXXXXXXXXXXXGOOOOOOOOOOOOOOOOOOOAOGOOOOOOOOOOOOOOOOOOOOOGOOOOOOOOAXXXXXXXXXXXXGOOOOOOOOOXXXXXXXXXXXXGOOOOOOOOOOOOAXXXXXXXXGOOOOOOOOOOXXXXXXXXXXX,0,0,0

4200,189,10,179,175,236,0,0,416,333,83,GOOOOOOOOOOOOOOOOOOAAOGOOOOOOOOOOOOOOOOOOOOOGOOOOOOOOOOXXXXXXXXXXXGOOOOOOOOOOAXXXXXXXXXXGOOOOOOOOOAXXXXXXXXXXXGOOOOOOOOAAXXXXXXXXXXXGOOOOOOOAOOXXXXXXXXXXXGOOOOOOOOOOOOOOOOOOOAOGOOOOOOOOOOOOOOOOOOOOOGOOOOOOOOAXXXXXXXXXXXXGOOOOOOOOOXXXXXXXXXXXXGOOOOOOOOOOOOAXXXXXXXXGOOOOOOOOOOXXXXXXXXXXX,0,0,0
4221,190,11,179,174,236,0,0,416,330,86,GOOOOOOOOOOOOOOOOOOAAOGOOOOOOOOOOOOOOOOOOOOOGOOOOOOOOOOXXXXXXXXXXXGOOOOOOOOOOAXXXXXXXXXXGOOOOOOOOOAAXXXXXXXXXXGOOOOOOOOAAXXXXXXXXXXXGOOOOOOOAOOXXXXXXXXXXXGOOOOOOOOOOOOOOOOOOOAOGOOOOOOOOOOOOOOOOOOOOOGOOOOOOOOAXXXXXXXXXXXXGOOOOOOOOOXXXXXXXXXXXXGOOOOOOOOOOOOAXXXXXXXXGOOOOOOOOOOXXXXXXXXXXX,0,0,0
4242,190,11,179,168,242,0,0,422,334,88,GOOOOOOOOOOOOOOOOOOAAOGOOOOOOOOOOOOOOOOOOOOOGOOOOOOOOOOXXXXXXXXXXXGOOOOOOOOOOAXXXXXXXXXXGOOOOOOOOOAAXXXXXXXXXXGOOOOOOOOAAXXXXXXXXXXXGOOOOOOOAOOXXXXXXXXXXXGOOOOOOOOOOOOOOOOOOOAOGOOOOOOOOOOOOOOOOOOOOOGOOOOOOOOAXXXXXXXXXXXXGOOOOOOOOOXXXXXXXXXXXXGOOOOOOOOOOOOAXXXXXXXXGOOOOOOOOOOXXXXXXXXXXX,0,0,0
4263,190,11,179,169,241,0,0,421,333,88,GOOOOOOOOOOOOOOOOOOAAOGOOOOOOOOOOOOOOOOOOOOOGOOOOOOOOOOXXXXXXXXXXXGOOOOOOOOOOAXXXXXXXXXXGOOOOOOOOOAAXXXXXXXXXXGOOOOOOOOAAXXXXXXXXXXXGOOOOOOOAOOXXXXXXXXXXXGOOOOOOOOOOOOOOOOOOOAOGOOOOOOOOOOOOOOOOOOOOOGOOOOOOOOAXXXXXXXXXXXXGOOOOOOOOOXXXXXXXXXXXXGOOOOOOOOOOOOAXXXXXXXXGOOOOOOOOOOXXXXXXXXXXX,0,0,0
4284,191,12,179,175,234,0,0,414,330,84,GOOOOOOOOOOOOOOOOOOAAOGOOOOOOOOOOOOOOOOOOOOOGOOOOOOOOOOXXXXXXXXXXXGOOOOOOOOOOAXXXXXXXXXXGOOOOOOOOOAAXXXXXXXXXXGOOOOOOOOAAXXXXXXXXXXXGOOOOOOOAOOAXXXXXXXXXXGOOOOOOOOOOOOOOOOOOOAOGOOOOOOOOOOOOOOOOOOOOOGOOOOOOOOAXXXXXXXXXXXXGOOOOOOOOOXXXXXXXXXXXXGOOOOOOOOOOOOAXXXXXXXXGOOOOOOOOOOXXXXXXXXXXX,0,0,0

4305,191,12,179,180,229,0,0,409,326,83,GOOOOOOOOOOOOOOOOOOAAOGOOOOOOOOOOOOOOOOOOOOOGOOOOOOOOOOXXXXXXXXXXXGOOOOOOOOOOAXXXXXXXXXXGOOOOOOOOOAAXXXXXXXXXXGOOOOOOOOAAXXXXXXXXXXXGOOOOOOOAOOAXXXXXXXXXXGOOOOOOOOOOOOOOOOOOOAOGOOOOOOOOOOOOOOOOOOOOOGOOOOOOOOAXXXXXXXXXXXXGOOOOOOOOOXXXXXXXXXXXXGOOOOOOOOOOOOAXXXXXXXXGOOOOOOOOOOXXXXXXXXXXX,0,0,0
4326,191,12,179,180,229,0,0,408,330,78,GOOOOOOOOOOOOOOOOOOAAOGOOOOOOOOOOOOOOOOOOOOOGOOOOOOOOOOXXXXXXXXXXXGOOOOOOOOOOAXXXXXXXXXXGOOOOOOOOOAAXXXXXXXXXXGOOOOOOOOAAXXXXXXXXXXXGOOOOOOOAOOAXXXXXXXXXXGOOOOOOOOOOOOOOOOOOOAOGOOOOOOOOOOOOOOOOOOOOOGOOOOOOOOAXXXXXXXXXXXXGOOOOOOOOOXXXXXXXXXXXXGOOOOOOOOOOOOAXXXXXXXXGOOOOOOOOOOXXXXXXXXXXX,0,0,0
4347,191,12,179,178,231,0,0,410,328,82,GOOOOOOOOOOOOOOOOOOAAOGOOOOOOOOOOOOOOOOOOOOOGOOOOOOOOOOXXXXXXXXXXXGOOOOOOOOOOAXXXXXXXXXXGOOOOOOOOOAAXXXXXXXXXXGOOOOOOOOAAXXXXXXXXXXXGOOOOOOOAOOAXXXXXXXXXXGOOOOOOOOOOOOOOOOOOOAOGOOOOOOOOOOOOOOOOOOOOOGOOOOOOOOAXXXXXXXXXXXXGOOOOOOOOOXXXXXXXXXXXXGOOOOOOOOOOOOAXXXXXXXXGOOOOOOOOOOXXXXXXXXXXX,0,0,0
4368,191,12,179,181,228,0,0,408,325,83,GOOOOOOOOOOOOOOOOOOAAOGOOOOOOOOOOOOOOOOOOOOOGOOOOOOOOOOXXXXXXXXXXXGOOOOOOOOOOAXXXXXXXXXXGOOOOOOOOOAAXXXXXXXXXXGOOOOOOOOAAXXXXXXXXXXXGOOOOOOOAOOAXXXXXXXXXXGOOOOOOOOOOOOOOOOOOOAOGOOOOOOOOOOOOOOOOOOOOOGOOOOOOOOAXXXXXXXXXXXXGOOOOOOOOOXXXXXXXXXXXXGOOOOOOOOOOOOAXXXXXXXXGOOOOOOOOOOXXXXXXXXXXX,0,0,0
4389,192,13,179,177,231,0,0,409,326,83,GOOOOOOOOOOOOOOOOOOAAOGOOOOOOOOOOOOOOOOOOOOOGOOOOOOOOOOXXXXXXXXXXXGOOOOOOOOOOAXXXXXXXXXXGOOOOOOOOOAAXXXXXXXXXXGOOOOOOOOAAXXXXXXXXXXXGOOOOOOOAOOAAXXXXXXXXXGOOOOOOOOOOOOOOOOOOOAOGOOOOOOOOOOOOOOOOOOOOOGOOOOOOOOAXXXXXXXXXXXXGOOOOOOOOOXXXXXXXXXXXXGOOOOOOOOOOOOAXXXXXXXXGOOOOOOOOOOXXXXXXXXXXX,0,0,0

4410,193,14,179,181,226,0,0,407,325,82,GOOOOOOOOOOOOOOOOOOAAOGOOOOOOOOOOOOOOOOOOOOOGOOOOOOOOOOXXXXXXXXXXXGOOOOOOOOOOAXXXXXXXXXXGOOOOOOOOOAAXXXXXXXXXXGOOOOOOOOAAAXXXXXXXXXXGOOOOOOOAOOAAXXXXXXXXXGOOOOOOOOOOOOOOOOOOOAOGOOOOOOOOOOOOOOOOOOOOOGOOOOOOOOAXXXXXXXXXXXXGOOOOOOOOOXXXXXXXXXXXXGOOOOOOOOOOOOAXXXXXXXXGOOOOOOOOOOXXXXXXXXXXX,0,0,0
4431,193,14,179,181,226,0,0,407,330,77,GOOOOOOOOOOOOOOOOOOAAOGOOOOOOOOOOOOOOOOOOOOOGOOOOOOOOOOXXXXXXXXXXXGOOOOOOOOOOAXXXXXXXXXXGOOOOOOOOOAAXXXXXXXXXXGOOOOOOOOAAAXXXXXXXXXXGOOOOOOOAOOAAXXXXXXXXXGOOOOOOOOOOOOOOOOOOOAOGOOOOOOOOOOOOOOOOOOOOOGOOOOOOOOAXXXXXXXXXXXXGOOOOOOOOOXXXXXXXXXXXXGOOOOOOOOOOOOAXXXXXXXXGOOOOOOOOOOXXXXXXXXXXX,0,0,0
4452,193,14,179,178,229,0,0,410,334,76,GOOOOOOOOOOOOOOOOOOAAOGOOOOOOOOOOOOOOOOOOOOOGOOOOOOOOOOXXXXXXXXXXXGOOOOOOOOOOAXXXXXXXXXXGOOOOOOOOOAAXXXXXXXXXXGOOOOOOOOAAAXXXXXXXXXXGOOOOOOOAOOAAXXXXXXXXXGOOOOOOOOOOOOOOOOOOOAOGOOOOOOOOOOOOOOOOOOOOOGOOOOOOOOAXXXXXXXXXXXXGOOOOOOOOOXXXXXXXXXXXXGOOOOOOOOOOOOAXXXXXXXXGOOOOOOOOOOXXXXXXXXXXX,0,0,0
4473,194,15,179,176,230,0,0,411,333,78,GOOOOOOOOOOOOOOOOOOAAOGOOOOOOOOOOOOOOOOOOOOOGOOOOOOOOOOXXXXXXXXXXXGOOOOOOOOOOAXXXXXXXXXXGOOOOOOOOOAAXXXXXXXXXXGOOOOOOOOAAAXXXXXXXXXXGOOOOOOOAOOAAAXXXXXXXXGOOOOOOOOOOOOOOOOOOOAOGOOOOOOOOOOOOOOOOOOOOOGOOOOOOOOAXXXXXXXXXXXXGOOOOOOOOOXXXXXXXXXXXXGOOOOOOOOOOOOAXXXXXXXXGOOOOOOOOOOXXXXXXXXXXX,0,0,0
4494,194,15,179,173,233,0,0,414,336,78,GOOOOOOOOOOOOOOOOOOAAOGOOOOOOOOOOOOOOOOOOOOOGOOOOOOOOOOXXXXXXXXXXXGOOOOOOOOOOAXXXXXXXXXXGOOOOOOOOOAAXXXXXXXXXXGOOOOOOOOAAAXXXXXXXXXXGOOOOOOOAOOAAAXXXXXXXXGOOOOOOOOOOOOOOOOOOOAOGOOOOOOOOOOOOOOOOOOOOOGOOOOOOOOAXXXXXXXXXXXXGOOOOOOOOOXXXXXXXXXXXXGOOOOOOOOOOOOAXXXXXXXXGOOOOOOOOOOXXXXXXXXXXX,0,0,0

4515,194,15,179,174,232,0,0,412,333,79,GOOOOOOOOOOOOOOOOOOAAOGOOOOOOOOOOOOOOOOOOOOOGOOOOOOOOOOXXXXXXXXXXXGOOOOOOOOOOAXXXXXXXXXXGOOOOOOOOOAAXXXXXXXXXXGOOOOOOOOAAAXXXXXXXXXXGOOOOOOOAOOAAAXXXXXXXXGOOOOOOOOOOOOOOOOOOOAOGOOOOOOOOOOOOOOOOOOOOOGOOOOOOOOAXXXXXXXXXXXXGOOOOOOOOOXXXXXXXXXXXXGOOOOOOOOOOOOAXXXXXXXXGOOOOOOOOOOXXXXXXXXXXX,0,0,0
4536,194,15,179,174,232,0,0,413,336,77,GOOOOOOOOOOOOOOOOOOAAOGOOOOOOOOOOOOOOOOOOOOOGOOOOOOOOOOXXXXXXXXXXXGOOOOOOOOOOAXXXXXXXXXXGOOOOOOOOOAAXXXXXXXXXXGOOOOOOOOAAAXXXXXXXXXXGOOOOOOOAOOAAAXXXXXXXXGOOOOOOOOOOOOOOOOOOOAOGOOOOOOOOOOOOOOOOOOOOOGOOOOOOOOAXXXXXXXXXXXXGOOOOOOOOOXXXXXXXXXXXXGOOOOOOOOOOOOAXXXXXXXXGOOOOOOOOOOXXXXXXXXXXX,0,0,0
4557,196,16,180,172,232,0,0,414,337,77,GOOOOOOOOOOOOOOOOOOAAOGOOOOOOOOOOOOOOOOOOOOOGOOOOOOOOOOXXXXXXXXXXXGOOOOOOOOOOAXXXXXXXXXXGOOOOOOOOOOAXXXXXXXXXXGOOOOOOOOAAAXXXXXXXXXXGOOOOOOOAOOAAAXXXXXXXXGOOOOOOOOOOOOOOOOOOOAOGOOOOOOOOOOOOOOOOOOOOOGOOOOOOOOAXXXXXXXXXXXXGOOOOOOOOOXXXXXXXXXXXXGOOOOOOOOOOOOAAAXXXXXXGOOOOOOOOOOXXXXXXXXXXX,0,0,0
4578,196,16,180,172,232,0,0,413,337,76,GOOOOOOOOOOOOOOOOOOAAOGOOOOOOOOOOOOOOOOOOOOOGOOOOOOOOOOXXXXXXXXXXXGOOOOOOOOOOAXXXXXXXXXXGOOOOOOOOOOAXXXXXXXXXXGOOOOOOOOAAAXXXXXXXXXXGOOOOOOOAOOAAAXXXXXXXXGOOOOOOOOOOOOOOOOOOOAOGOOOOOOOOOOOOOOOOOOOOOGOOOOOOOOAXXXXXXXXXXXXGOOOOOOOOOXXXXXXXXXXXXGOOOOOOOOOOOOAAAXXXXXXGOOOOOOOOOOXXXXXXXXXXX,0,0,0
4599,196,16,180,169,235,0,0,415,336,79,GOOOOOOOOOOOOOOOOOOAAOGOOOOOOOOOOOOOOOOOOOOOGOOOOOOOOOOXXXXXXXXXXXGOOOOOOOOOOAXXXXXXXXXXGOOOOOOOOOOAXXXXXXXXXXGOOOOOOOOAAAXXXXXXXXXXGOOOOOOOAOOAAAXXXXXXXXGOOOOOOOOOOOOOOOOOOOAOGOOOOOOOOOOOOOOOOOOOOOGOOOOOOOOAXXXXXXXXXXXXGOOOOOOOOOXXXXXXXXXXXXGOOOOOOOOOOOOAAAXXXXXXGOOOOOOOOOOXXXXXXXXXXX,0,0,0

4620,197,16,181,168,235,0,0,416,333,83,GOOOOOOOOOOOOOOOOOOAAOGOOOOOOOOOOOOOOOOOOOOOGOOOOOOOOOOXXXXXXXXXXXGOOOOOOOOOOAXXXXXXXXXXGOOOOOOOOOOAXXXXXXXXXXGOOOOOOOOAAAXXXXXXXXXXGOOOOOOOAOOAAAXXXXXXXXGOOOOOOOOOOOOOOOOOOOOOGOOOOOOOOOOOOOOOOOOOOOGOOOOOOOOAAXXXXXXXXXXXGOOOOOOOOOXXXXXXXXXXXXGOOOOOOOOOOOOAAAXXXXXXGOOOOOOOOOOXXXXXXXXXXX,0,0,0
4641,198,17,181,169,233,0,0,415,335,80,GOOOOOOOOOOOOOOOOOOAAOGOOOOOOOOOOOOOOOOOOOOOGOOOOOOOOOOXXXXXXXXXXXGOOOOOOOOOOAXXXXXXXXXXGOOOOOOOOOOAXXXXXXXXXXGOOOOOOOOAAAXXXXXXXXXXGOOOOOOOAOOAAAXXXXXXXXGOOOOOOOOOOOOOOOOOOOOOGOOOOOOOOOOOOOOOOOOOOOGOOOOOOOOAAAXXXXXXXXXXGOOOOOOOOOXXXXXXXXXXXXGOOOOOOOOOOOOAAAXXXXXXGOOOOOOOOOOXXXXXXXXXXX,0,0,0
4662,199,18,181,170,231,0,0,412,336,76,GOOOOOOOOOOOOOOOOOOAAOGOOOOOOOOOOOOOOOOOOOOOGOOOOOOOOOOXXXXXXXXXXXGOOOOOOOOOOAXXXXXXXXXXGOOOOOOOOOOAXXXXXXXXXXGOOOOOOOOAAAAXXXXXXXXXGOOOOOOOAOOAAAXXXXXXXXGOOOOOOOOOOOOOOOOOOOOOGOOOOOOOOOOOOOOOOOOOOOGOOOOOOOOAAAXXXXXXXXXXGOOOOOOOOOXXXXXXXXXXXXGOOOOOOOOOOOOAAAXXXXXXGOOOOOOOOOOXXXXXXXXXXX,0,0,0
4683,199,18,181,170,231,0,0,413,337,76,GOOOOOOOOOOOOOOOOOOAAOGOOOOOOOOOOOOOOOOOOOOOGOOOOOOOOOOXXXXXXXXXXXGOOOOOOOOOOAXXXXXXXXXXGOOOOOOOOOOAXXXXXXXXXXGOOOOOOOOAAAAXXXXXXXXXGOOOOOOOAOOAAAXXXXXXXXGOOOOOOOOOOOOOOOOOOOOOGOOOOOOOOOOOOOOOOOOOOOGOOOOOOOOAAAXXXXXXXXXXGOOOOOOOOOXXXXXXXXXXXXGOOOOOOOOOOOOAAAXXXXXXGOOOOOOOOOOXXXXXXXXXXX,0,0,0
4704,199,18,181,170,231,0,0,412,342,70,GOOOOOOOOOOOOOOOOOOAAOGOOOOOOOOOOOOOOOOOOOOOGOOOOOOOOOOXXXXXXXXXXXGOOOOOOOOOOAXXXXXXXXXXGOOOOOOOOOOAXXXXXXXXXXGOOOOOOOOAAAAXXXXXXXXXGOOOOOOOAOOAAAXXXXXXXXGOOOOOOOOOOOOOOOOOOOOOGOOOOOOOOOOOOOOOOOOOOOGOOOOOOOOAAAXXXXXXXXXXGOOOOOOOOOXXXXXXXXXXXXGOOOOOOOOOOOOAAAXXXXXXGOOOOOOOOOOXXXXXXXXXXX,0,0,0

4725,199,17,182,171,230,0,0,413,338,75,GOOOOOOOOOOOOOOOOOOAAOGOOOOOOOOOOOOOOOOOOOOOGOOOOOOOOOOXXXXXXXXXXXGOOOOOOOOOOAXXXXXXXXXXGOOOOOOOOOOAXXXXXXXXXXGOOOOOOOOOAAAXXXXXXXXXGOOOOOOOAOOAAAXXXXXXXXGOOOOOOOOOOOOOOOOOOOOOGOOOOOOOOOOOOOOOOOOOOOGOOOOOOOOAAAXXXXXXXXXXGOOOOOOOOOXXXXXXXXXXXXGOOOOOOOOOOOOAAAXXXXXXGOOOOOOOOOOXXXXXXXXXXX,0,0,0
4746,199,16,183,177,224,0,0,406,333,73,GOOOOOOOOOOOOOOOOOOAOOGOOOOOOOOOOOOOOOOOOOOOGOOOOOOOOOOXXXXXXXXXXXGOOOOOOOOOOAXXXXXXXXXXGOOOOOOOOOOAXXXXXXXXXXGOOOOOOOOOAAAXXXXXXXXXGOOOOOOOAOOAAAXXXXXXXXGOOOOOOOOOOOOOOOOOOOOOGOOOOOOOOOOOOOOOOOOOOOGOOOOOOOOAAAXXXXXXXXXXGOOOOOOOOOXXXXXXXXXXXXGOOOOOOOOOOOOAAAXXXXXXGOOOOOOOOOOXXXXXXXXXXX,0,0,0
4767,201,18,183,181,218,0,0,402,328,74,GOOOOOOOOOOOOOOOOOOAOOGOOOOOOOOOOOOOOOOOOOOOGOOOOOOOOOOXXXXXXXXXXXGOOOOOOOOOOAXXXXXXXXXXGOOOOOOOOOOAXXXXXXXXXXGOOOOOOOOOAAAAAXXXXXXXGOOOOOOOAOOAAAXXXXXXXXGOOOOOOOOOOOOOOOOOOOOOGOOOOOOOOOOOOOOOOOOOOOGOOOOOOOOAAAXXXXXXXXXXGOOOOOOOOOXXXXXXXXXXXXGOOOOOOOOOOOOAAAXXXXXXGOOOOOOOOOOXXXXXXXXXXX,0,0,0
4788,202,17,185,179,219,0,0,405,329,76,GOOOOOOOOOOOOOOOOOOAOOGOOOOOOOOOOOOOOOOOOOOOGOOOOOOOOOOXXXXXXXXXXXGOOOOOOOOOOAXXXXXXXXXXGOOOOOOOOOOAXXXXXXXXXXGOOOOOOOOOAAAAAXXXXXXXGOOOOOOOOOOOAAXXXXXXXXGOOOOOOOOOOOOOOOOOOOOOGOOOOOOOOOOOOOOOOOOOOOGOOOOOOOOAAAXXXXXXXXXXGOOOOOOOOOXXXXXXXXXXXXGOOOOOOOOOOOOAAAAXXXXXGOOOOOOOOOOXXXXXXXXXXX,0,0,0
4809,203,18,185,186,211,0,0,397,323,74,GOOOOOOOOOOOOOOOOOOAOOGOOOOOOOOOOOOOOOOOOOOOGOOOOOOOOOOXXXXXXXXXXXGOOOOOOOOOOAXXXXXXXXXXGOOOOOOOOOOAXXXXXXXXXXGOOOOOOOOOAAAAAXXXXXXXGOOOOOOOOOOOAAAXXXXXXXGOOOOOOOOOOOOOOOOOOOOOGOOOOOOOOOOOOOOOOOOOOOGOOOOOOOOAAAXXXXXXXXXXGOOOOOOOOOXXXXXXXXXXXXGOOOOOOOOOOOOAAAAXXXXXGOOOOOOOOOOXXXXXXXXXXX,0,0,0

4830,203,18,185,184,213,0,0,397,323,74,GOOOOOOOOOOOOOOOOOOAOOGOOOOOOOOOOOOOOOOOOOOOGOOOOOOOOOOXXXXXXXXXXXGOOOOOOOOOOAXXXXXXXXXXGOOOOOOOOOOAXXXXXXXXXXGOOOOOOOOOAAAAAXXXXXXXGOOOOOOOOOOOAAAXXXXXXXGOOOOOOOOOOOOOOOOOOOOOGOOOOOOOOOOOOOOOOOOOOOGOOOOOOOOAAAXXXXXXXXXXGOOOOOOOOOXXXXXXXXXXXXGOOOOOOOOOOOOAAAAXXXXXGOOOOOOOOOOXXXXXXXXXXX,0,0,0
4851,203,18,185,188,209,0,0,395,321,74,GOOOOOOOOOOOOOOOOOOAOOGOOOOOOOOOOOOOOOOOOOOOGOOOOOOOOOOXXXXXXXXXXXGOOOOOOOOOOAXXXXXXXXXXGOOOOOOOOOOAXXXXXXXXXXGOOOOOOOOOAAAAAXXXXXXXGOOOOOOOOOOOAAAXXXXXXXGOOOOOOOOOOOOOOOOOOOOOGOOOOOOOOOOOOOOOOOOOOOGOOOOOOOOAAAXXXXXXXXXXGOOOOOOOOOXXXXXXXXXXXXGOOOOOOOOOOOOAAAAXXXXXGOOOOOOOOOOXXXXXXXXXXX,0,0,0
4872,203,16,187,190,207,0,0,395,318,77,GOOOOOOOOOOOOOOOOOOOOOGOOOOOOOOOOOOOOOOOOOOOGOOOOOOOOOOXXXXXXXXXXXGOOOOOOOOOOAXXXXXXXXXXGOOOOOOOOOOAXXXXXXXXXXGOOOOOOOOOAAAAAXXXXXXXGOOOOOOOOOOOAAAXXXXXXXGOOOOOOOOOOOOOOOOOOOOOGOOOOOOOOOOOOOOOOOOOOOGOOOOOOOOAAAXXXXXXXXXXGOOOOOOOOOXXXXXXXXXXXXGOOOOOOOOOOOOAAAOXXXXXGOOOOOOOOOOXXXXXXXXXXX,0,0,0
4893,203,15,188,193,204,0,0,393,317,76,GOOOOOOOOOOOOOOOOOOOOOGOOOOOOOOOOOOOOOOOOOOOGOOOOOOOOOOXXXXXXXXXXXGOOOOOOOOOOAXXXXXXXXXXGOOOOOOOOOOAXXXXXXXXXXGOOOOOOOOOAAAAAXXXXXXXGOOOOOOOOOOOAAAXXXXXXXGOOOOOOOOOOOOOOOOOOOOOGOOOOOOOOOOOOOOOOOOOOOGOOOOOOOOOAAXXXXXXXXXXGOOOOOOOOOXXXXXXXXXXXXGOOOOOOOOOOOOAAAOXXXXXGOOOOOOOOOOXXXXXXXXXXX,0,0,0
4914,204,15,189,189,207,0,0,398,319,79,GOOOOOOOOOOOOOOOOOOOOOGOOOOOOOOOOOOOOOOOOOOOGOOOOOOOOOOXXXXXXXXXXXGOOOOOOOOOOAXXXXXXXXXXGOOOOOOOOOOAAXXXXXXXXXGOOOOOOOOOOAAAAXXXXXXXGOOOOOOOOOOOAAAXXXXXXXGOOOOOOOOOOOOOOOOOOOOOGOOOOOOOOOOOOOOOOOOOOOGOOOOOOOOOAAXXXXXXXXXXGOOOOOOOOOXXXXXXXXXXXXGOOOOOOOOOOOOAAAOXXXXXGOOOOOOOOOOXXXXXXXXXXX,0,0,0

4935,205,16,189,190,205,0,0,396,318,78,GOOOOOOOOOOOOOOOOOOOOOGOOOOOOOOOOOOOOOOOOOOOGOOOOOOOOOOXXXXXXXXXXXGOOOOOOOOOOAXXXXXXXXXXGOOOOOOOOOOAAAXXXXXXXXGOOOOOOOOOOAAAAXXXXXXXGOOOOOOOOOOOAAAXXXXXXXGOOOOOOOOOOOOOOOOOOOOOGOOOOOOOOOOOOOOOOOOOOOGOOOOOOOOOAAXXXXXXXXXXGOOOOOOOOOXXXXXXXXXXXXGOOOOOOOOOOOOAAAOXXXXXGOOOOOOOOOOXXXXXXXXXXX,0,0,0
4956,205,16,189,188,207,0,0,398,317,81,GOOOOOOOOOOOOOOOOOOOOOGOOOOOOOOOOOOOOOOOOOOOGOOOOOOOOOOXXXXXXXXXXXGOOOOOOOOOOAXXXXXXXXXXGOOOOOOOOOOAAAXXXXXXXXGOOOOOOOOOOAAAAXXXXXXXGOOOOOOOOOOOAAAXXXXXXXGOOOOOOOOOOOOOOOOOOOOOGOOOOOOOOOOOOOOOOOOOOOGOOOOOOOOOAAXXXXXXXXXXGOOOOOOOOOXXXXXXXXXXXXGOOOOOOOOOOOOAAAOXXXXXGOOOOOOOOOOXXXXXXXXXXX,0,0,0
4977,206,17,189,187,207,0,0,398,317,81,GOOOOOOOOOOOOOOOOOOOOOGOOOOOOOOOOOOOOOOOOOOOGOOOOOOOOOOXXXXXXXXXXXGOOOOOOOOOOAXXXXXXXXXXGOOOOOOOOOOAAAXXXXXXXXGOOOOOOOOOOAAAAXXXXXXXGOOOOOOOOOOOAAAXXXXXXXGOOOOOOOOOOOOOOOOOOOOOGOOOOOOOOOOOOOOOOOOOOOGOOOOOOOOOAAAXXXXXXXXXGOOOOOOOOOXXXXXXXXXXXXGOOOOOOOOOOOOAAAOXXXXXGOOOOOOOOOOXXXXXXXXXXX,0,0,0
4998,206,17,189,188,206,0,0,397,316,81,GOOOOOOOOOOOOOOOOOOOOOGOOOOOOOOOOOOOOOOOOOOOGOOOOOOOOOOXXXXXXXXXXXGOOOOOOOOOOAXXXXXXXXXXGOOOOOOOOOOAAAXXXXXXXXGOOOOOOOOOOAAAAXXXXXXXGOOOOOOOOOOOAAAXXXXXXXGOOOOOOOOOOOOOOOOOOOOOGOOOOOOOOOOOOOOOOOOOOOGOOOOOOOOOAAAXXXXXXXXXGOOOOOOOOOXXXXXXXXXXXXGOOOOOOOOOOOOAAAOXXXXXGOOOOOOOOOOXXXXXXXXXXX,0,0,0
5019,206,17,189,185,209,0,0,400,314,86,GOOOOOOOOOOOOOOOOOOOOOGOOOOOOOOOOOOOOOOOOOOOGOOOOOOOOOOXXXXXXXXXXXGOOOOOOOOOOAXXXXXXXXXXGOOOOOOOOOOAAAXXXXXXXXGOOOOOOOOOOAAAAXXXXXXXGOOOOOOOOOOOAAAXXXXXXXGOOOOOOOOOOOOOOOOOOOOOGOOOOOOOOOOOOOOOOOOOOOGOOOOOOOOOAAAXXXXXXXXXGOOOOOOOOOXXXXXXXXXXXXGOOOOOOOOOOOOAAAOXXXXXGOOOOOOOOOOXXXXXXXXXXX,0,0,0

5040,206,17,189,182,212,0,0,403,320,83,GOOOOOOOOOOOOOOOOOOOOOGOOOOOOOOOOOOOOOOOOOOOGOOOOOOOOOOXXXXXXXXXXXGOOOOOOOOOOAXXXXXXXXXXGOOOOOOOOOOAAAXXXXXXXXGOOOOOOOOOOAAAAXXXXXXXGOOOOOOOOOOOAAAXXXXXXXGOOOOOOOOOOOOOOOOOOOOOGOOOOOOOOOOOOOOOOOOOOOGOOOOOOOOOAAAXXXXXXXXXGOOOOOOOOOXXXXXXXXXXXXGOOOOOOOOOOOOAAAOXXXXXGOOOOOOOOOOXXXXXXXXXXX,0,0,0
5061,206,16,190,180,214,0,0,406,318,88,GOOOOOOOOOOOOOOOOOOOOOGOOOOOOOOOOOOOOOOOOOOOGOOOOOOOOOOXXXXXXXXXXXGOOOOOOOOOOAXXXXXXXXXXGOOOOOOOOOOOAAXXXXXXXXGOOOOOOOOOOAAAAXXXXXXXGOOOOOOOOOOOAAAXXXXXXXGOOOOOOOOOOOOOOOOOOOOOGOOOOOOOOOOOOOOOOOOOOOGOOOOOOOOOAAAXXXXXXXXXGOOOOOOOOOXXXXXXXXXXXXGOOOOOOOOOOOOAAAOXXXXXGOOOOOOOOOOXXXXXXXXXXX,0,0,0
5082,206,16,190,184,210,0,0,402,313,89,GOOOOOOOOOOOOOOOOOOOOOGOOOOOOOOOOOOOOOOOOOOOGOOOOOOOOOOXXXXXXXXXXXGOOOOOOOOOOAXXXXXXXXXXGOOOOOOOOOOOAAXXXXXXXXGOOOOOOOOOOAAAAXXXXXXXGOOOOOOOOOOOAAAXXXXXXXGOOOOOOOOOOOOOOOOOOOOOGOOOOOOOOOOOOOOOOOOOOOGOOOOOOOOOAAAXXXXXXXXXGOOOOOOOOOXXXXXXXXXXXXGOOOOOOOOOOOOAAAOXXXXXGOOOOOOOOOOXXXXXXXXXXX,0,0,0
5103,207,16,191,180,213,0,0,405,314,91,GOOOOOOOOOOOOOOOOOOOOOGOOOOOOOOOOOOOOOOOOOOOGOOOOOOOOOOXXXXXXXXXXXGOOOOOOOOOOAAXXXXXXXXXGOOOOOOOOOOOAAXXXXXXXXGOOOOOOOOOOAAAAXXXXXXXGOOOOOOOOOOOAAAXXXXXXXGOOOOOOOOOOOOOOOOOOOOOGOOOOOOOOOOOOOOOOOOOOOGOOOOOOOOOAAAXXXXXXXXXGOOOOOOOOOXXXXXXXXXXXXGOOOOOOOOOOOOAAOOXXXXXGOOOOOOOOOOXXXXXXXXXXX,0,0,0
5124,209,17,192,176,215,0,0,408,314,94,GOOOOOOOOOOOOOOOOOOOOOGOOOOOOOOOOOOOOOOOOOOOGOOOOOOOOOOXXXXXXXXXXXGOOOOOOOOOOOAXXXXXXXXXGOOOOOOOOOOOAAXXXXXXXXGOOOOOOOOOOAAAAXXXXXXXGOOOOOOOOOOOAAAXXXXXXXGOOOOOOOOOOOOOOOOOOOOOGOOOOOOOOOOOOOOOOOOOOOGOOOOOOOOOAAAXXXXXXXXXGOOOOOOOOOXXXXXXXXXXXXGOOOOOOOOOOOOAAOOAXXXXGOOOOOOOOOOAXXXXXXXXXX,0,0,0

5145,209,17,192,176,215,0,0,408,315,93,GOOOOOOOOOOOOOOOOOOOOOGOOOOOOOOOOOOOOOOOOOOOGOOOOOOOOOOXXXXXXXXXXXGOOOOOOOOOOOAXXXXXXXXXGOOOOOOOOOOOAAXXXXXXXXGOOOOOOOOOOAAAAXXXXXXXGOOOOOOOOOOOAAAXXXXXXXGOOOOOOOOOOOOOOOOOOOOOGOOOOOOOOOOOOOOOOOOOOOGOOOOOOOOOAAAXXXXXXXXXGOOOOOOOOOXXXXXXXXXXXXGOOOOOOOOOOOOAAOOAXXXXGOOOOOOOOOOAXXXXXXXXXX,0,0,0
5166,211,19,192,174,215,0,0,407,314,93,GOOOOOOOOOOOOOOOOOOOOOGOOOOOOOOOOOOOOOOOOOOOGOOOOOOOOOOAXXXXXXXXXXGOOOOOOOOOOOAXXXXXXXXXGOOOOOOOOOOOAAXXXXXXXXGOOOOOOOOOOAAAAXXXXXXXGOOOOOOOOOOOAAAXXXXXXXGOOOOOOOOOOOOOOOOOOOOOGOOOOOOOOOOOOOOOOOOOOOGOOOOOOOOOAAAAXXXXXXXXGOOOOOOOOOXXXXXXXXXXXXGOOOOOOOOOOOOAAOOAXXXXGOOOOOOOOOOAXXXXXXXXXX,0,0,0
5187,211,19,192,168,221,0,0,414,321,93,GOOOOOOOOOOOOOOOOOOOOOGOOOOOOOOOOOOOOOOOOOOOGOOOOOOOOOOAXXXXXXXXXXGOOOOOOOOOOOAXXXXXXXXXGOOOOOOOOOOOAAXXXXXXXXGOOOOOOOOOOAAAAXXXXXXXGOOOOOOOOOOOAAAXXXXXXXGOOOOOOOOOOOOOOOOOOOOOGOOOOOOOOOOOOOOOOOOOOOGOOOOOOOOOAAAAXXXXXXXXGOOOOOOOOOXXXXXXXXXXXXGOOOOOOOOOOOOAAOOAXXXXGOOOOOOOOOOAXXXXXXXXXX,0,0,0
5208,211,18,193,167,222,0,0,416,322,94,GOOOOOOOOOOOOOOOOOOOOOGOOOOOOOOOOOOOOOOOOOOOGOOOOOOOOOOAXXXXXXXXXXGOOOOOOOOOOOAXXXXXXXXXGOOOOOOOOOOOAAXXXXXXXXGOOOOOOOOOOAAAAXXXXXXXGOOOOOOOOOOOAAAXXXXXXXGOOOOOOOOOOOOOOOOOOOOOGOOOOOOOOOOOOOOOOOOOOOGOOOOOOOOOOAAAXXXXXXXXGOOOOOOOOOXXXXXXXXXXXXGOOOOOOOOOOOOAAOOAXXXXGOOOOOOOOOOAXXXXXXXXXX,0,0,0
5229,211,16,195,166,223,0,0,419,323,96,GOOOOOOOOOOOOOOOOOOOOOGOOOOOOOOOOOOOOOOOOOOOGOOOOOOOOOOOXXXXXXXXXXGOOOOOOOOOOOAXXXXXXXXXGOOOOOOOOOOOAAXXXXXXXXGOOOOOOOOOOAAAAXXXXXXXGOOOOOOOOOOOAAAXXXXXXXGOOOOOOOOOOOOOOOOOOOOOGOOOOOOOOOOOOOOOOOOOOOGOOOOOOOOOOAAAXXXXXXXXGOOOOOOOOOXXXXXXXXXXXXGOOOOOOOOOOOOAOOOAXXXXGOOOOOOOOOOAXXXXXXXXXX,0,0,0

5250,212,17,195,162,226,0,0,421,326,95,GOOOOOOOOOOOOOOOOOOOOOGOOOOOOOOOOOOOOOOOOOOOGOOOOOOOOOOOXXXXXXXXXXGOOOOOOOOOOOAXXXXXXXXXGOOOOOOOOOOOAAXXXXXXXXGOOOOOOOOOOAAAAXXXXXXXGOOOOOOOOOOOAAAXXXXXXXGOOOOOOOOOOOOOOOOOOOOOGOOOOOOOOOOOOOOOOOOOOOGOOOOOOOOOOAAAXXXXXXXXGOOOOOOOOOXXXXXXXXXXXXGOOOOOOOOOOOOAOOOAAXXXGOOOOOOOOOOAXXXXXXXXXX,0,0,0
5271,213,18,195,156,231,0,0,426,328,98,GOOOOOOOOOOOOOOOOOOOOOGOOOOOOOOOOOOOOOOOOOOOGOOOOOOOOOOOXXXXXXXXXXGOOOOOOOOOOOAXXXXXXXXXGOOOOOOOOOOOAAXXXXXXXXGOOOOOOOOOOAAAAXXXXXXXGOOOOOOOOOOOAAAXXXXXXXGOOOOOOOOOOOOOOOOOOOOOGOOOOOOOOOOOOOOOOOOOOOGOOOOOOOOOOAAAXXXXXXXXGOOOOOOOOOAXXXXXXXXXXXGOOOOOOOOOOOOAOOOAAXXXGOOOOOOOOOOAXXXXXXXXXX,0,0,0
5292,214,19,195,155,231,0,0,427,329,98,GOOOOOOOOOOOOOOOOOOOOOGOOOOOOOOOOOOOOOOOOOOOGOOOOOOOOOOOXXXXXXXXXXGOOOOOOOOOOOAXXXXXXXXXGOOOOOOOOOOOAAXXXXXXXXGOOOOOOOOOOAAAAXXXXXXXGOOOOOOOOOOOAAAXXXXXXXGOOOOOOOOOOOOOOOOOOOOOGOOOOOOOOOOOOOOOOOOOOOGOOOOOOOOOOAAAXXXXXXXXGOOOOOOOOOAAXXXXXXXXXXGOOOOOOOOOOOOAOOOAAXXXGOOOOOOOOOOAXXXXXXXXXX,0,0,0
5313,214,19,195,158,228,0,0,424,327,97,GOOOOOOOOOOOOOOOOOOOOOGOOOOOOOOOOOOOOOOOOOOOGOOOOOOOOOOOXXXXXXXXXXGOOOOOOOOOOOAXXXXXXXXXGOOOOOOOOOOOAAXXXXXXXXGOOOOOOOOOOAAAAXXXXXXXGOOOOOOOOOOOAAAXXXXXXXGOOOOOOOOOOOOOOOOOOOOOGOOOOOOOOOOOOOOOOOOOOOGOOOOOOOOOOAAAXXXXXXXXGOOOOOOOOOAAXXXXXXXXXXGOOOOOOOOOOOOAOOOAAXXXGOOOOOOOOOOAXXXXXXXXXX,0,0,0
5334,216,18,198,158,226,0,0,424,328,96,GOOOOOOOOOOOOOOOOOOOOOGOOOOOOOOOOOOOOOOOOOOOGOOOOOOOOOOOAXXXXXXXXXGOOOOOOOOOOOOXXXXXXXXXGOOOOOOOOOOOOAXXXXXXXXGOOOOOOOOOOAAAAAXXXXXXGOOOOOOOOOOOAAAXXXXXXXGOOOOOOOOOOOOOOOOOOOOOGOOOOOOOOOOOOOOOOOOOOOGOOOOOOOOOOAAOXXXXXXXXGOOOOOOOOOAAXXXXXXXXXXGOOOOOOOOOOOOAOOOAAXXXGOOOOOOOOOOAXXXXXXXXXX,0,0,0

5355,216,18,198,159,225,0,0,423,326,97,GOOOOOOOOOOOOOOOOOOOOOGOOOOOOOOOOOOOOOOOOOOOGOOOOOOOOOOOAXXXXXXXXXGOOOOOOOOOOOOXXXXXXXXXGOOOOOOOOOOOOAXXXXXXXXGOOOOOOOOOOAAAAAXXXXXXGOOOOOOOOOOOAAAXXXXXXXGOOOOOOOOOOOOOOOOOOOOOGOOOOOOOOOOOOOOOOOOOOOGOOOOOOOOOOAAOXXXXXXXXGOOOOOOOOOAAXXXXXXXXXXGOOOOOOOOOOOOAOOOAAXXXGOOOOOOOOOOAXXXXXXXXXX,0,0,0
5376,217,18,199,158,225,0,0,425,332,93,GOOOOOOOOOOOOOOOOOOOOOGOOOOOOOOOOOOOOOOOOOOOGOOOOOOOOOOOAXXXXXXXXXGOOOOOOOOOOOOXXXXXXXXXGOOOOOOOOOOOOAAXXXXXXXGOOOOOOOOOOAAAAAXXXXXXGOOOOOOOOOOOAAAXXXXXXXGOOOOOOOOOOOOOOOOOOOOOGOOOOOOOOOOOOOOOOOOOOOGOOOOOOOOOOOAOXXXXXXXXGOOOOOOOOOAAXXXXXXXXXXGOOOOOOOOOOOOAOOOAAXXXGOOOOOOOOOOAXXXXXXXXXX,0,0,0
5397,218,19,199,158,224,0,0,423,330,93,GOOOOOOOOOOOOOOOOOOOOOGOOOOOOOOOOOOOOOOOOOOOGOOOOOOOOOOOAXXXXXXXXXGOOOOOOOOOOOOXXXXXXXXXGOOOOOOOOOOOOAAXXXXXXXGOOOOOOOOOOAAAAAAXXXXXGOOOOOOOOOOOAAAXXXXXXXGOOOOOOOOOOOOOOOOOOOOOGOOOOOOOOOOOOOOOOOOOOOGOOOOOOOOOOOAOXXXXXXXXGOOOOOOOOOAAXXXXXXXXXXGOOOOOOOOOOOOAOOOAAXXXGOOOOOOOOOOAXXXXXXXXXX,0,0,0
5418,218,18,200,162,220,0,0,421,328,93,GOOOOOOOOOOOOOOOOOOOOOGOOOOOOOOOOOOOOOOOOOOOGOOOOOOOOOOOAXXXXXXXXXGOOOOOOOOOOOOXXXXXXXXXGOOOOOOOOOOOOAAXXXXXXXGOOOOOOOOOOAAAAAAXXXXXGOOOOOOOOOOOAOAXXXXXXXGOOOOOOOOOOOOOOOOOOOOOGOOOOOOOOOOOOOOOOOOOOOGOOOOOOOOOOOAOXXXXXXXXGOOOOOOOOOAAXXXXXXXXXXGOOOOOOOOOOOOAOOOAAXXXGOOOOOOOOOOAXXXXXXXXXX,0,0,0
5439,218,16,202,170,212,0,0,415,324,91,GOOOOOOOOOOOOOOOOOOOOOGOOOOOOOOOOOOOOOOOOOOOGOOOOOOOOOOOOXXXXXXXXXGOOOOOOOOOOOOXXXXXXXXXGOOOOOOOOOOOOAAXXXXXXXGOOOOOOOOOOAAAAAAXXXXXGOOOOOOOOOOOAOAXXXXXXXGOOOOOOOOOOOOOOOOOOOOOGOOOOOOOOOOOOOOOOOOOOOGOOOOOOOOOOOAOXXXXXXXXGOOOOOOOOOAAXXXXXXXXXXGOOOOOOOOOOOOOOOOAAXXXGOOOOOOOOOOAXXXXXXXXXX,0,0,0

5460,218,16,202,171,211,0,0,414,327,87,GOOOOOOOOOOOOOOOOOOOOOGOOOOOOOOOOOOOOOOOOOOOGOOOOOOOOOOOOXXXXXXXXXGOOOOOOOOOOOOXXXXXXXXXGOOOOOOOOOOOOAAXXXXXXXGOOOOOOOOOOAAAAAAXXXXXGOOOOOOOOOOOAOAXXXXXXXGOOOOOOOOOOOOOOOOOOOOOGOOOOOOOOOOOOOOOOOOOOOGOOOOOOOOOOOAOXXXXXXXXGOOOOOOOOOAAXXXXXXXXXXGOOOOOOOOOOOOOOOOAAXXXGOOOOOOOOOOAXXXXXXXXXX,0,0,0
5481,218,16,202,172,210,0,0,414,333,81,GOOOOOOOOOOOOOOOOOOOOOGOOOOOOOOOOOOOOOOOOOOOGOOOOOOOOOOOOXXXXXXXXXGOOOOOOOOOOOOXXXXXXXXXGOOOOOOOOOOOOAAXXXXXXXGOOOOOOOOOOAAAAAAXXXXXGOOOOOOOOOOOAOAXXXXXXXGOOOOOOOOOOOOOOOOOOOOOGOOOOOOOOOOOOOOOOOOOOOGOOOOOOOOOOOAOXXXXXXXXGOOOOOOOOOAAXXXXXXXXXXGOOOOOOOOOOOOOOOOAAXXXGOOOOOOOOOOAXXXXXXXXXX,0,0,0
5502,218,16,202,169,213,0,0,417,334,83,GOOOOOOOOOOOOOOOOOOOOOGOOOOOOOOOOOOOOOOOOOOOGOOOOOOOOOOOOXXXXXXXXXGOOOOOOOOOOOOXXXXXXXXXGOOOOOOOOOOOOAAXXXXXXXGOOOOOOOOOOAAAAAAXXXXXGOOOOOOOOOOOAOAXXXXXXXGOOOOOOOOOOOOOOOOOOOOOGOOOOOOOOOOOOOOOOOOOOOGOOOOOOOOOOOAOXXXXXXXXGOOOOOOOOOAAXXXXXXXXXXGOOOOOOOOOOOOOOOOAAXXXGOOOOOOOOOOAXXXXXXXXXX,0,0,0
5523,219,16,203,167,214,0,0,418,336,82,GOOOOOOOOOOOOOOOOOOOOOGOOOOOOOOOOOOOOOOOOOOOGOOOOOOOOOOOOXXXXXXXXXGOOOOOOOOOOOOXXXXXXXXXGOOOOOOOOOOOOAAXXXXXXXGOOOOOOOOOOAAAAAAXXXXXGOOOOOOOOOOOAOAXXXXXXXGOOOOOOOOOOOOOOOOOOOOOGOOOOOOOOOOOOOOOOOOOOOGOOOOOOOOOOOAOXXXXXXXXGOOOOOOOOOOAXXXXXXXXXXGOOOOOOOOOOOOOOOOAAAXXGOOOOOOOOOOAXXXXXXXXXX,0,0,0
5544,220,17,203,166,214,0,0,419,338,81,GOOOOOOOOOOOOOOOOOOOOOGOOOOOOOOOOOOOOOOOOOOOGOOOOOOOOOOOOXXXXXXXXXGOOOOOOOOOOOOXXXXXXXXXGOOOOOOOOOOOOAAXXXXXXXGOOOOOOOOOOAAAAAAXXXXXGOOOOOOOOOOOAOAXXXXXXXGOOOOOOOOOOOOOOOOOOOOOGOOOOOOOOOOOOOOOOOOOOOGOOOOOOOOOOOAOXXXXXXXXGOOOOOOOOOOAXXXXXXXXXXGOOOOOOOOOOOOOOOOAAAAXGOOOOOOOOOOAXXXXXXXXXX,0,0,0

5565,220,16,204,170,210,0,0,416,338,78,GOOOOOOOOOOOOOOOOOOOOOGOOOOOOOOOOOOOOOOOOOOOGOOOOOOOOOOOOXXXXXXXXXGOOOOOOOOOOOOXXXXXXXXXGOOOOOOOOOOOOAAXXXXXXXGOOOOOOOOOOAAOAAAXXXXXGOOOOOOOOOOOAOAXXXXXXXGOOOOOOOOOOOOOOOOOOOOOGOOOOOOOOOOOOOOOOOOOOOGOOOOOOOOOOOAOXXXXXXXXGOOOOOOOOOOAXXXXXXXXXXGOOOOOOOOOOOOOOOOAAAAXGOOOOOOOOOOAXXXXXXXXXX,0,0,0
5586,220,16,204,170,210,0,0,414,337,77,GOOOOOOOOOOOOOOOOOOOOOGOOOOOOOOOOOOOOOOOOOOOGOOOOOOOOOOOOXXXXXXXXXGOOOOOOOOOOOOXXXXXXXXXGOOOOOOOOOOOOAAXXXXXXXGOOOOOOOOOOAAOAAAXXXXXGOOOOOOOOOOOAOAXXXXXXXGOOOOOOOOOOOOOOOOOOOOOGOOOOOOOOOOOOOOOOOOOOOGOOOOOOOOOOOAOXXXXXXXXGOOOOOOOOOOAXXXXXXXXXXGOOOOOOOOOOOOOOOOAAAAXGOOOOOOOOOOAXXXXXXXXXX,0,0,0
5607,220,16,204,170,210,0,0,416,340,76,GOOOOOOOOOOOOOOOOOOOOOGOOOOOOOOOOOOOOOOOOOOOGOOOOOOOOOOOOXXXXXXXXXGOOOOOOOOOOOOXXXXXXXXXGOOOOOOOOOOOOAAXXXXXXXGOOOOOOOOOOAAOAAAXXXXXGOOOOOOOOOOOAOAXXXXXXXGOOOOOOOOOOOOOOOOOOOOOGOOOOOOOOOOOOOOOOOOOOOGOOOOOOOOOOOAOXXXXXXXXGOOOOOOOOOOAXXXXXXXXXXGOOOOOOOOOOOOOOOOAAAAXGOOOOOOOOOOAXXXXXXXXXX,0,0,0
5628,220,14,206,165,215,0,0,422,341,81,GOOOOOOOOOOOOOOOOOOOOOGOOOOOOOOOOOOOOOOOOOOOGOOOOOOOOOOOOXXXXXXXXXGOOOOOOOOOOOOXXXXXXXXXGOOOOOOOOOOOOAAXXXXXXXGOOOOOOOOOOAAOAAAXXXXXGOOOOOOOOOOOOOAXXXXXXXGOOOOOOOOOOOOOOOOOOOOOGOOOOOOOOOOOOOOOOOOOOOGOOOOOOOOOOOOOXXXXXXXXGOOOOOOOOOOAXXXXXXXXXXGOOOOOOOOOOOOOOOOAAAAXGOOOOOOOOOOAXXXXXXXXXX,0,0,0
5649,220,14,206,166,214,0,0,422,347,75,GOOOOOOOOOOOOOOOOOOOOOGOOOOOOOOOOOOOOOOOOOOOGOOOOOOOOOOOOXXXXXXXXXGOOOOOOOOOOOOXXXXXXXXXGOOOOOOOOOOOOAAXXXXXXXGOOOOOOOOOOAAOAAAXXXXXGOOOOOOOOOOOOOAXXXXXXXGOOOOOOOOOOOOOOOOOOOOOGOOOOOOOOOOOOOOOOOOOOOGOOOOOOOOOOOOOXXXXXXXXGOOOOOOOOOOAXXXXXXXXXXGOOOOOOOOOOOOOOOOAAAAXGOOOOOOOOOOAXXXXXXXXXX,0,0,0

5670,222,16,206,163,215,0,0,423,349,74,GOOOOOOOOOOOOOOOOOOOOOGOOOOOOOOOOOOOOOOOOOOOGOOOOOOOOOOOOXXXXXXXXXGOOOOOOOOOOOOXXXXXXXXXGOOOOOOOOOOOOAAXXXXXXXGOOOOOOOOOOAAOAAAAXXXXGOOOOOOOOOOOOOAXXXXXXXGOOOOOOOOOOOOOOOOOOOOOGOOOOOOOOOOOOOOOOOOOOOGOOOOOOOOOOOOOXXXXXXXXGOOOOOOOOOOAXXXXXXXXXXGOOOOOOOOOOOOOOOOAAAAAGOOOOOOOOOOAXXXXXXXXXX,0,0,0
5691,222,15,207,165,213,0,0,421,346,75,GOOOOOOOOOOOOOOOOOOOOOGOOOOOOOOOOOOOOOOOOOOOGOOOOOOOOOOOOXXXXXXXXXGOOOOOOOOOOOOXXXXXXXXXGOOOOOOOOOOOOAAXXXXXXXGOOOOOOOOOOAAOAAAAXXXXGOOOOOOOOOOOOOAXXXXXXXGOOOOOOOOOOOOOOOOOOOOOGOOOOOOOOOOOOOOOOOOOOOGOOOOOOOOOOOOOXXXXXXXXGOOOOOOOOOOOXXXXXXXXXXGOOOOOOOOOOOOOOOOAAAAAGOOOOOOOOOOAXXXXXXXXXX,0,0,0
5712,222,13,209,166,212,0,0,423,347,76,GOOOOOOOOOOOOOOOOOOOOOGOOOOOOOOOOOOOOOOOOOOOGOOOOOOOOOOOOXXXXXXXXXGOOOOOOOOOOOOXXXXXXXXXGOOOOOOOOOOOOAAXXXXXXXGOOOOOOOOOOAAOAOAAXXXXGOOOOOOOOOOOOOAXXXXXXXGOOOOOOOOOOOOOOOOOOOOOGOOOOOOOOOOOOOOOOOOOOOGOOOOOOOOOOOOOXXXXXXXXGOOOOOOOOOOOXXXXXXXXXXGOOOOOOOOOOOOOOOOAOAAAGOOOOOOOOOOAXXXXXXXXXX,0,0,0
5733,222,12,210,167,211,0,0,423,348,75,GOOOOOOOOOOOOOOOOOOOOOGOOOOOOOOOOOOOOOOOOOOOGOOOOOOOOOOOOXXXXXXXXXGOOOOOOOOOOOOXXXXXXXXXGOOOOOOOOOOOOAAXXXXXXXGOOOOOOOOOOAOOAOAAXXXXGOOOOOOOOOOOOOAXXXXXXXGOOOOOOOOOOOOOOOOOOOOOGOOOOOOOOOOOOOOOOOOOOOGOOOOOOOOOOOOOXXXXXXXXGOOOOOOOOOOOXXXXXXXXXXGOOOOOOOOOOOOOOOOAOAAAGOOOOOOOOOOAXXXXXXXXXX,0,0,0
5754,222,11,211,164,214,0,0,427,346,81,GOOOOOOOOOOOOOOOOOOOOOGOOOOOOOOOOOOOOOOOOOOOGOOOOOOOOOOOOXXXXXXXXXGOOOOOOOOOOOOXXXXXXXXXGOOOOOOOOOOOOOAXXXXXXXGOOOOOOOOOOAOOAOAAXXXXGOOOOOOOOOOOOOAXXXXXXXGOOOOOOOOOOOOOOOOOOOOOGOOOOOOOOOOOOOOOOOOOOOGOOOOOOOOOOOOOXXXXXXXXGOOOOOOOOOOOXXXXXXXXXXGOOOOOOOOOOOOOOOOAOAAAGOOOOOOOOOOAXXXXXXXXXX,0,0,0

5775,225,12,213,161,214,0,0,429,346,83,GOOOOOOOOOOOOOOOOOOOOOGOOOOOOOOOOOOOOOOOOOOOGOOOOOOOOOOOOXXXXXXXXXGOOOOOOOOOOOOXXXXXXXXXGOOOOOOOOOOOOOAXXXXXXXGOOOOOOOOOOOOOAOAAAXXXGOOOOOOOOOOOOOAXXXXXXXGOOOOOOOOOOOOOOOOOOOOOGOOOOOOOOOOOOOOOOOOOOOGOOOOOOOOOOOOOOAXXXXXXGOOOOOOOOOOOXXXXXXXXXXGOOOOOOOOOOOOOOOOAOAAAGOOOOOOOOOOAXXXXXXXXXX,0,0,0
5796,225,12,213,157,218,0,0,433,352,81,GOOOOOOOOOOOOOOOOOOOOOGOOOOOOOOOOOOOOOOOOOOOGOOOOOOOOOOOOXXXXXXXXXGOOOOOOOOOOOOXXXXXXXXXGOOOOOOOOOOOOOAXXXXXXXGOOOOOOOOOOOOOAOAAAXXXGOOOOOOOOOOOOOAXXXXXXXGOOOOOOOOOOOOOOOOOOOOOGOOOOOOOOOOOOOOOOOOOOOGOOOOOOOOOOOOOOAXXXXXXGOOOOOOOOOOOXXXXXXXXXXGOOOOOOOOOOOOOOOOAOAAAGOOOOOOOOOOAXXXXXXXXXX,0,0,0
5817,225,12,213,160,215,0,0,430,350,80,GOOOOOOOOOOOOOOOOOOOOOGOOOOOOOOOOOOOOOOOOOOOGOOOOOOOOOOOOXXXXXXXXXGOOOOOOOOOOOOXXXXXXXXXGOOOOOOOOOOOOOAXXXXXXXGOOOOOOOOOOOOOAOAAAXXXGOOOOOOOOOOOOOAXXXXXXXGOOOOOOOOOOOOOOOOOOOOOGOOOOOOOOOOOOOOOOOOOOOGOOOOOOOOOOOOOOAXXXXXXGOOOOOOOOOOOXXXXXXXXXXGOOOOOOOOOOOOOOOOAOAAAGOOOOOOOOOOAXXXXXXXXXX,0,0,0
5838,225,12,213,162,213,0,0,428,350,78,GOOOOOOOOOOOOOOOOOOOOOGOOOOOOOOOOOOOOOOOOOOOGOOOOOOOOOOOOXXXXXXXXXGOOOOOOOOOOOOXXXXXXXXXGOOOOOOOOOOOOOAXXXXXXXGOOOOOOOOOOOOOAOAAAXXXGOOOOOOOOOOOOOAXXXXXXXGOOOOOOOOOOOOOOOOOOOOOGOOOOOOOOOOOOOOOOOOOOOGOOOOOOOOOOOOOOAXXXXXXGOOOOOOOOOOOXXXXXXXXXXGOOOOOOOOOOOOOOOOAOAAAGOOOOOOOOOOAXXXXXXXXXX,0,0,0
5859,226,12,214,168,206,0,0,421,339,82,GOOOOOOOOOOOOOOOOOOOOOGOOOOOOOOOOOOOOOOOOOOOGOOOOOOOOOOOOXXXXXXXXXGOOOOOOOOOOOOXXXXXXXXXGOOOOOOOOOOOOOAXXXXXXXGOOOOOOOOOOOOOAOAAAXXXGOOOOOOOOOOOOOOAXXXXXXGOOOOOOOOOOOOOOOOOOOOOGOOOOOOOOOOOOOOOOOOOOOGOOOOOOOOOOOOOOAXXXXXXGOOOOOOOOOOOXXXXXXXXXXGOOOOOOOOOOOOOOOOAOAAAGOOOOOOOOOOAXXXXXXXXXX,0,0,0

5880,227,13,214,165,208,0,0,422,340,82,GOOOOOOOOOOOOOOOOOOOOOGOOOOOOOOOOOOOOOOOOOOOGOOOOOOOOOOOOXXXXXXXXXGOOOOOOOOOOOOXXXXXXXXXGOOOOOOOOOOOOOAXXXXXXXGOOOOOOOOOOOOOAOAAAAXXGOOOOOOOOOOOOOOAXXXXXXGOOOOOOOOOOOOOOOOOOOOOGOOOOOOOOOOOOOOOOOOOOOGOOOOOOOOOOOOOOAXXXXXXGOOOOOOOOOOOXXXXXXXXXXGOOOOOOOOOOOOOOOOAOAAAGOOOOOOOOOOAXXXXXXXXXX,0,0,0
5901,229,14,215,161,210,0,0,426,339,87,GOOOOOOOOOOOOOOOOOOOOOGOOOOOOOOOOOOOOOOOOOOOGOOOOOOOOOOOOXXXXXXXXXGOOOOOOOOOOOOXXXXXXXXXGOOOOOOOOOOOOOAXXXXXXXGOOOOOOOOOOOOOAOAAAAAAGOOOOOOOOOOOOOOAXXXXXXGOOOOOOOOOOOOOOOOOOOOOGOOOOOOOOOOOOOOOOOOOOOGOOOOOOOOOOOOOOAXXXXXXGOOOOOOOOOOOXXXXXXXXXXGOOOOOOOOOOOOOOOOOOAAAGOOOOOOOOOOAXXXXXXXXXX,0,0,0
5922,229,14,215,168,203,0,0,419,338,81,GOOOOOOOOOOOOOOOOOOOOOGOOOOOOOOOOOOOOOOOOOOOGOOOOOOOOOOOOXXXXXXXXXGOOOOOOOOOOOOXXXXXXXXXGOOOOOOOOOOOOOAXXXXXXXGOOOOOOOOOOOOOAOAAAAAAGOOOOOOOOOOOOOOAXXXXXXGOOOOOOOOOOOOOOOOOOOOOGOOOOOOOOOOOOOOOOOOOOOGOOOOOOOOOOOOOOAXXXXXXGOOOOOOOOOOOXXXXXXXXXXGOOOOOOOOOOOOOOOOOOAAAGOOOOOOOOOOAXXXXXXXXXX,0,0,0
5943,229,14,215,167,204,0,0,419,339,80,GOOOOOOOOOOOOOOOOOOOOOGOOOOOOOOOOOOOOOOOOOOOGOOOOOOOOOOOOXXXXXXXXXGOOOOOOOOOOOOXXXXXXXXXGOOOOOOOOOOOOOAXXXXXXXGOOOOOOOOOOOOOAOAAAAAAGOOOOOOOOOOOOOOAXXXXXXGOOOOOOOOOOOOOOOOOOOOOGOOOOOOOOOOOOOOOOOOOOOGOOOOOOOOOOOOOOAXXXXXXGOOOOOOOOOOOXXXXXXXXXXGOOOOOOOOOOOOOOOOOOAAAGOOOOOOOOOOAXXXXXXXXXX,0,0,0
5964,229,14,215,171,200,0,0,417,341,76,GOOOOOOOOOOOOOOOOOOOOOGOOOOOOOOOOOOOOOOOOOOOGOOOOOOOOOOOOXXXXXXXXXGOOOOOOOOOOOOXXXXXXXXXGOOOOOOOOOOOOOAXXXXXXXGOOOOOOOOOOOOOAOAAAAAAGOOOOOOOOOOOOOOAXXXXXXGOOOOOOOOOOOOOOOOOOOOOGOOOOOOOOOOOOOOOOOOOOOGOOOOOOOOOOOOOOAXXXXXXGOOOOOOOOOOOXXXXXXXXXXGOOOOOOOOOOOOOOOOOOAAAGOOOOOOOOOOAXXXXXXXXXX,0,0,0

5985,230,15,215,173,197,0,0,414,345,69,GOOOOOOOOOOOOOOOOOOOOOGOOOOOOOOOOOOOOOOOOOOOGOOOOOOOOOOOOXXXXXXXXXGOOOOOOOOOOOOXXXXXXXXXGOOOOOOOOOOOOOAXXXXXXXGOOOOOOOOOOOOOAOAAAAAAGOOOOOOOOOOOOOOAAXXXXXGOOOOOOOOOOOOOOOOOOOOOGOOOOOOOOOOOOOOOOOOOOOGOOOOOOOOOOOOOOAXXXXXXGOOOOOOOOOOOXXXXXXXXXXGOOOOOOOOOOOOOOOOOOAAAGOOOOOOOOOOAXXXXXXXXXX,0,0,0
6006,232,16,216,175,193,0,0,410,342,68,GOOOOOOOOOOOOOOOOOOOOOGOOOOOOOOOOOOOOOOOOOOOGOOOOOOOOOOOOXXXXXXXXXGOOOOOOOOOOOOXXXXXXXXXGOOOOOOOOOOOOOOXXXXXXXGOOOOOOOOOOOOOAOAAAAAAGOOOOOOOOOOOOOOAAXXXXXGOOOOOOOOOOOOOOOOOOOOOGOOOOOOOOOOOOOOOOOOOOOGOOOOOOOOOOOOOOAAXXXXXGOOOOOOOOOOOAXXXXXXXXXGOOOOOOOOOOOOOOOOOOAAAGOOOOOOOOOOAXXXXXXXXXX,0,0,0
6027,233,16,217,177,190,0,0,409,343,66,GOOOOOOOOOOOOOOOOOOOOOGOOOOOOOOOOOOOOOOOOOOOGOOOOOOOOOOOOXXXXXXXXXGOOOOOOOOOOOOXXXXXXXXXGOOOOOOOOOOOOOOXXXXXXXGOOOOOOOOOOOOOOOAAAAAAGOOOOOOOOOOOOOOAAXXXXXGOOOOOOOOOOOOOOOOOOOOOGOOOOOOOOOOOOOOOOOOOOOGOOOOOOOOOOOOOOAAXXXXXGOOOOOOOOOOOAXXXXXXXXXGOOOOOOOOOOOOOOOOOOAAAGOOOOOOOOOOAAXXXXXXXXX,0,0,0
6048,233,16,217,174,193,0,0,412,344,68,GOOOOOOOOOOOOOOOOOOOOOGOOOOOOOOOOOOOOOOOOOOOGOOOOOOOOOOOOXXXXXXXXXGOOOOOOOOOOOOXXXXXXXXXGOOOOOOOOOOOOOOXXXXXXXGOOOOOOOOOOOOOOOAAAAAAGOOOOOOOOOOOOOOAAXXXXXGOOOOOOOOOOOOOOOOOOOOOGOOOOOOOOOOOOOOOOOOOOOGOOOOOOOOOOOOOOAAXXXXXGOOOOOOOOOOOAXXXXXXXXXGOOOOOOOOOOOOOOOOOOAAAGOOOOOOOOOOAAXXXXXXXXX,0,0,0
6069,236,18,218,173,191,0,0,411,347,64,GOOOOOOOOOOOOOOOOOOOOOGOOOOOOOOOOOOOOOOOOOOOGOOOOOOOOOOOOXXXXXXXXXGOOOOOOOOOOOOXXXXXXXXXGOOOOOOOOOOOOOOXXXXXXXGOOOOOOOOOOOOOOOAAAAAAGOOOOOOOOOOOOOOAAXXXXXGOOOOOOOOOOOOOOOOOOOOOGOOOOOOOOOOOOOOOOOOOOOGOOOOOOOOOOOOOOAAAAAXXGOOOOOOOOOOOAXXXXXXXXXGOOOOOOOOOOOOOOOOOOOAAGOOOOOOOOOOAAXXXXXXXXX,0,0,0

6090,236,18,218,170,194,0,0,415,351,64,GOOOOOOOOOOOOOOOOOOOOOGOOOOOOOOOOOOOOOOOOOOOGOOOOOOOOOOOOXXXXXXXXXGOOOOOOOOOOOOXXXXXXXXXGOOOOOOOOOOOOOOXXXXXXXGOOOOOOOOOOOOOOOAAAAAAGOOOOOOOOOOOOOOAAXXXXXGOOOOOOOOOOOOOOOOOOOOOGOOOOOOOOOOOOOOOOOOOOOGOOOOOOOOOOOOOOAAAAAXXGOOOOOOOOOOOAXXXXXXXXXGOOOOOOOOOOOOOOOOOOOAAGOOOOOOOOOOAAXXXXXXXXX,0,0,0
6111,237,19,218,169,194,0,0,415,353,62,GOOOOOOOOOOOOOOOOOOOOOGOOOOOOOOOOOOOOOOOOOOOGOOOOOOOOOOOOXXXXXXXXXGOOOOOOOOOOOOXXXXXXXXXGOOOOOOOOOOOOOOXXXXXXXGOOOOOOOOOOOOOOOAAAAAAGOOOOOOOOOOOOOOAAXXXXXGOOOOOOOOOOOOOOOOOOOOOGOOOOOOOOOOOOOOOOOOOOOGOOOOOOOOOOOOOOAAAAAAXGOOOOOOOOOOOAXXXXXXXXXGOOOOOOOOOOOOOOOOOOOAAGOOOOOOOOOOAAXXXXXXXXX,0,0,0
6132,237,19,218,167,196,0,0,417,353,64,GOOOOOOOOOOOOOOOOOOOOOGOOOOOOOOOOOOOOOOOOOOOGOOOOOOOOOOOOXXXXXXXXXGOOOOOOOOOOOOXXXXXXXXXGOOOOOOOOOOOOOOXXXXXXXGOOOOOOOOOOOOOOOAAAAAAGOOOOOOOOOOOOOOAAXXXXXGOOOOOOOOOOOOOOOOOOOOOGOOOOOOOOOOOOOOOOOOOOOGOOOOOOOOOOOOOOAAAAAAXGOOOOOOOOOOOAXXXXXXXXXGOOOOOOOOOOOOOOOOOOOAAGOOOOOOOOOOAAXXXXXXXXX,0,0,0
6153,238,18,220,163,199,0,0,421,351,70,GOOOOOOOOOOOOOOOOOOOOOGOOOOOOOOOOOOOOOOOOOOOGOOOOOOOOOOOOXXXXXXXXXGOOOOOOOOOOOOXXXXXXXXXGOOOOOOOOOOOOOOXXXXXXXGOOOOOOOOOOOOOOOOOAAAAGOOOOOOOOOOOOOOAAXXXXXGOOOOOOOOOOOOOOOOOOOOOGOOOOOOOOOOOOOOOOOOOOOGOOOOOOOOOOOOOOAAAAAAAGOOOOOOOOOOOAXXXXXXXXXGOOOOOOOOOOOOOOOOOOOAAGOOOOOOOOOOAAXXXXXXXXX,0,0,0
6174,238,18,220,164,198,0,0,421,350,71,GOOOOOOOOOOOOOOOOOOOOOGOOOOOOOOOOOOOOOOOOOOOGOOOOOOOOOOOOXXXXXXXXXGOOOOOOOOOOOOXXXXXXXXXGOOOOOOOOOOOOOOXXXXXXXGOOOOOOOOOOOOOOOOOAAAAGOOOOOOOOOOOOOOAAXXXXXGOOOOOOOOOOOOOOOOOOOOOGOOOOOOOOOOOOOOOOOOOOOGOOOOOOOOOOOOOOAAAAAAAGOOOOOOOOOOOAXXXXXXXXXGOOOOOOOOOOOOOOOOOOOAAGOOOOOOOOOOAAXXXXXXXXX,0,0,0

6195,239,18,221,163,198,0,0,422,351,71,GOOOOOOOOOOOOOOOOOOOOOGOOOOOOOOOOOOOOOOOOOOOGOOOOOOOOOOOOXXXXXXXXXGOOOOOOOOOOOOXXXXXXXXXGOOOOOOOOOOOOOOAXXXXXXGOOOOOOOOOOOOOOOOOAAAAGOOOOOOOOOOOOOOOAXXXXXGOOOOOOOOOOOOOOOOOOOOOGOOOOOOOOOOOOOOOOOOOOOGOOOOOOOOOOOOOOAAAAAAAGOOOOOOOOOOOAXXXXXXXXXGOOOOOOOOOOOOOOOOOOOAAGOOOOOOOOOOAAXXXXXXXXX,0,0,0
6216,240,19,221,161,199,0,0,423,348,75,GOOOOOOOOOOOOOOOOOOOOOGOOOOOOOOOOOOOOOOOOOOOGOOOOOOOOOOOOXXXXXXXXXGOOOOOOOOOOOOXXXXXXXXXGOOOOOOOOOOOOOOAXXXXXXGOOOOOOOOOOOOOOOOOAAAAGOOOOOOOOOOOOOOOAAXXXXGOOOOOOOOOOOOOOOOOOOOOGOOOOOOOOOOOOOOOOOOOOOGOOOOOOOOOOOOOOAAAAAAAGOOOOOOOOOOOAXXXXXXXXXGOOOOOOOOOOOOOOOOOOOAAGOOOOOOOOOOAAXXXXXXXXX,0,0,0
6237,241,20,221,155,204,0,0,427,349,78,GOOOOOOOOOOOOOOOOOOOOOGOOOOOOOOOOOOOOOOOOOOOGOOOOOOOOOOOOXXXXXXXXXGOOOOOOOOOOOOXXXXXXXXXGOOOOOOOOOOOOOOAXXXXXXGOOOOOOOOOOOOOOOOOAAAAGOOOOOOOOOOOOOOOAAAXXXGOOOOOOOOOOOOOOOOOOOOOGOOOOOOOOOOOOOOOOOOOOOGOOOOOOOOOOOOOOAAAAAAAGOOOOOOOOOOOAXXXXXXXXXGOOOOOOOOOOOOOOOOOOOAAGOOOOOOOOOOAAXXXXXXXXX,0,0,0
6258,241,19,222,159,200,0,0,424,346,78,GOOOOOOOOOOOOOOOOOOOOOGOOOOOOOOOOOOOOOOOOOOOGOOOOOOOOOOOOXXXXXXXXXGOOOOOOOOOOOOXXXXXXXXXGOOOOOOOOOOOOOOAXXXXXXGOOOOOOOOOOOOOOOOOAAAAGOOOOOOOOOOOOOOOAAAXXXGOOOOOOOOOOOOOOOOOOOOOGOOOOOOOOOOOOOOOOOOOOOGOOOOOOOOOOOOOOAOAAAAAGOOOOOOOOOOOAXXXXXXXXXGOOOOOOOOOOOOOOOOOOOAAGOOOOOOOOOOAAXXXXXXXXX,0,0,0
6279,241,18,223,160,199,0,0,424,345,79,GOOOOOOOOOOOOOOOOOOOOOGOOOOOOOOOOOOOOOOOOOOOGOOOOOOOOOOOOXXXXXXXXXGOOOOOOOOOOOOXXXXXXXXXGOOOOOOOOOOOOOOAXXXXXXGOOOOOOOOOOOOOOOOOAAAAGOOOOOOOOOOOOOOOAAAXXXGOOOOOOOOOOOOOOOOOOOOOGOOOOOOOOOOOOOOOOOOOOOGOOOOOOOOOOOOOOAOOAAAAGOOOOOOOOOOOAXXXXXXXXXGOOOOOOOOOOOOOOOOOOOAAGOOOOOOOOOOAAXXXXXXXXX,0,0,0

6300,241,18,223,159,200,0,0,425,340,85,GOOOOOOOOOOOOOOOOOOOOOGOOOOOOOOOOOOOOOOOOOOOGOOOOOOOOOOOOXXXXXXXXXGOOOOOOOOOOOOXXXXXXXXXGOOOOOOOOOOOOOOAXXXXXXGOOOOOOOOOOOOOOOOOAAAAGOOOOOOOOOOOOOOOAAAXXXGOOOOOOOOOOOOOOOOOOOOOGOOOOOOOOOOOOOOOOOOOOOGOOOOOOOOOOOOOOAOOAAAAGOOOOOOOOOOOAXXXXXXXXXGOOOOOOOOOOOOOOOOOOOAAGOOOOOOOOOOAAXXXXXXXXX,0,0,0
6321,242,16,226,159,199,0,0,427,340,87,GOOOOOOOOOOOOOOOOOOOOOGOOOOOOOOOOOOOOOOOOOOOGOOOOOOOOOOOOAXXXXXXXXGOOOOOOOOOOOOXXXXXXXXXGOOOOOOOOOOOOOOAXXXXXXGOOOOOOOOOOOOOOOOOAOAAGOOOOOOOOOOOOOOOAAAXXXGOOOOOOOOOOOOOOOOOOOOOGOOOOOOOOOOOOOOOOOOOOOGOOOOOOOOOOOOOOAOOAAAAGOOOOOOOOOOOOXXXXXXXXXGOOOOOOOOOOOOOOOOOOOAAGOOOOOOOOOOAOXXXXXXXXX,0,0,0
6342,242,15,227,158,200,0,0,429,341,88,GOOOOOOOOOOOOOOOOOOOOOGOOOOOOOOOOOOOOOOOOOOOGOOOOOOOOOOOOOXXXXXXXXGOOOOOOOOOOOOXXXXXXXXXGOOOOOOOOOOOOOOAXXXXXXGOOOOOOOOOOOOOOOOOAOAAGOOOOOOOOOOOOOOOAAAXXXGOOOOOOOOOOOOOOOOOOOOOGOOOOOOOOOOOOOOOOOOOOOGOOOOOOOOOOOOOOAOOAAAAGOOOOOOOOOOOOXXXXXXXXXGOOOOOOOOOOOOOOOOOOOAAGOOOOOOOOOOAOXXXXXXXXX,0,0,0
6363,242,14,228,153,205,0,0,435,344,91,GOOOOOOOOOOOOOOOOOOOOOGOOOOOOOOOOOOOOOOOOOOOGOOOOOOOOOOOOOXXXXXXXXGOOOOOOOOOOOOXXXXXXXXXGOOOOOOOOOOOOOOAXXXXXXGOOOOOOOOOOOOOOOOOAOAOGOOOOOOOOOOOOOOOAAAXXXGOOOOOOOOOOOOOOOOOOOOOGOOOOOOOOOOOOOOOOOOOOOGOOOOOOOOOOOOOOAOOAAAAGOOOOOOOOOOOOXXXXXXXXXGOOOOOOOOOOOOOOOOOOOAAGOOOOOOOOOOAOXXXXXXXXX,0,0,0
6384,242,13,229,150,208,0,0,439,337,102,GOOOOOOOOOOOOOOOOOOOOOGOOOOOOOOOOOOOOOOOOOOOGOOOOOOOOOOOOOXXXXXXXXGOOOOOOOOOOOOXXXXXXXXXGOOOOOOOOOOOOOOAXXXXXXGOOOOOOOOOOOOOOOOOAOAOGOOOOOOOOOOOOOOOAAOXXXGOOOOOOOOOOOOOOOOOOOOOGOOOOOOOOOOOOOOOOOOOOOGOOOOOOOOOOOOOOAOOAAAAGOOOOOOOOOOOOXXXXXXXXXGOOOOOOOOOOOOOOOOOOOAAGOOOOOOOOOOAOXXXXXXXXX,0,0,0

6405,242,13,229,146,212,0,0,443,338,105,GOOOOOOOOOOOOOOOOOOOOOGOOOOOOOOOOOOOOOOOOOOOGOOOOOOOOOOOOOXXXXXXXXGOOOOOOOOOOOOXXXXXXXXXGOOOOOOOOOOOOOOAXXXXXXGOOOOOOOOOOOOOOOOOAOAOGOOOOOOOOOOOOOOOAAOXXXGOOOOOOOOOOOOOOOOOOOOOGOOOOOOOOOOOOOOOOOOOOOGOOOOOOOOOOOOOOAOOAAAAGOOOOOOOOOOOOXXXXXXXXXGOOOOOOOOOOOOOOOOOOOAAGOOOOOOOOOOAOXXXXXXXXX,0,0,0
6426,242,13,229,147,211,0,0,442,339,103,GOOOOOOOOOOOOOOOOOOOOOGOOOOOOOOOOOOOOOOOOOOOGOOOOOOOOOOOOOXXXXXXXXGOOOOOOOOOOOOXXXXXXXXXGOOOOOOOOOOOOOOAXXXXXXGOOOOOOOOOOOOOOOOOAOAOGOOOOOOOOOOOOOOOAAOXXXGOOOOOOOOOOOOOOOOOOOOOGOOOOOOOOOOOOOOOOOOOOOGOOOOOOOOOOOOOOAOOAAAAGOOOOOOOOOOOOXXXXXXXXXGOOOOOOOOOOOOOOOOOOOAAGOOOOOOOOOOAOXXXXXXXXX,0,0,0
6447,242,13,229,143,215,0,0,446,341,105,GOOOOOOOOOOOOOOOOOOOOOGOOOOOOOOOOOOOOOOOOOOOGOOOOOOOOOOOOOXXXXXXXXGOOOOOOOOOOOOXXXXXXXXXGOOOOOOOOOOOOOOAXXXXXXGOOOOOOOOOOOOOOOOOAOAOGOOOOOOOOOOOOOOOAAOXXXGOOOOOOOOOOOOOOOOOOOOOGOOOOOOOOOOOOOOOOOOOOOGOOOOOOOOOOOOOOAOOAAAAGOOOOOOOOOOOOXXXXXXXXXGOOOOOOOOOOOOOOOOOOOAAGOOOOOOOOOOAOXXXXXXXXX,0,0,0
6468,243,14,229,146,211,0,0,442,337,105,GOOOOOOOOOOOOOOOOOOOOOGOOOOOOOOOOOOOOOOOOOOOGOOOOOOOOOOOOOXXXXXXXXGOOOOOOOOOOOOXXXXXXXXXGOOOOOOOOOOOOOOAAXXXXXGOOOOOOOOOOOOOOOOOAOAOGOOOOOOOOOOOOOOOAAOXXXGOOOOOOOOOOOOOOOOOOOOOGOOOOOOOOOOOOOOOOOOOOOGOOOOOOOOOOOOOOAOOAAAAGOOOOOOOOOOOOXXXXXXXXXGOOOOOOOOOOOOOOOOOOOAAGOOOOOOOOOOAOXXXXXXXXX,0,0,0
6489,243,13,230,144,213,0,0,444,337,107,GOOOOOOOOOOOOOOOOOOOOOGOOOOOOOOOOOOOOOOOOOOOGOOOOOOOOOOOOOXXXXXXXXGOOOOOOOOOOOOXXXXXXXXXGOOOOOOOOOOOOOOAAXXXXXGOOOOOOOOOOOOOOOOOAOOOGOOOOOOOOOOOOOOOAAOXXXGOOOOOOOOOOOOOOOOOOOOOGOOOOOOOOOOOOOOOOOOOOOGOOOOOOOOOOOOOOAOOAAAAGOOOOOOOOOOOOXXXXXXXXXGOOOOOOOOOOOOOOOOOOOAAGOOOOOOOOOOAOXXXXXXXXX,0,0,0

6510,243,12,231,147,210,0,0,443,336,107,GOOOOOOOOOOOOOOOOOOOOOGOOOOOOOOOOOOOOOOOOOOOGOOOOOOOOOOOOOXXXXXXXXGOOOOOOOOOOOOXXXXXXXXXGOOOOOOOOOOOOOOAAXXXXXGOOOOOOOOOOOOOOOOOAOOOGOOOOOOOOOOOOOOOAAOXXXGOOOOOOOOOOOOOOOOOOOOOGOOOOOOOOOOOOOOOOOOOOOGOOOOOOOOOOOOOOAOOAAAAGOOOOOOOOOOOOXXXXXXXXXGOOOOOOOOOOOOOOOOOOOOAGOOOOOOOOOOAOXXXXXXXXX,0,0,0
6531,243,10,233,150,207,0,0,441,337,104,GOOOOOOOOOOOOOOOOOOOOOGOOOOOOOOOOOOOOOOOOOOOGOOOOOOOOOOOOOXXXXXXXXGOOOOOOOOOOOOXXXXXXXXXGOOOOOOOOOOOOOOAOXXXXXGOOOOOOOOOOOOOOOOOAOOOGOOOOOOOOOOOOOOOAAOXXXGOOOOOOOOOOOOOOOOOOOOOGOOOOOOOOOOOOOOOOOOOOOGOOOOOOOOOOOOOOAOOAAOAGOOOOOOOOOOOOXXXXXXXXXGOOOOOOOOOOOOOOOOOOOOAGOOOOOOOOOOAOXXXXXXXXX,0,0,0
6552,244,11,233,152,204,0,0,437,334,103,GOOOOOOOOOOOOOOOOOOOOOGOOOOOOOOOOOOOOOOOOOOOGOOOOOOOOOOOOOXXXXXXXXGOOOOOOOOOOOOXXXXXXXXXGOOOOOOOOOOOOOOAOXXXXXGOOOOOOOOOOOOOOOOOAOOOGOOOOOOOOOOOOOOOAAOXXXGOOOOOOOOOOOOOOOOOOOOOGOOOOOOOOOOOOOOOOOOOOOGOOOOOOOOOOOOOOAOOAAOAGOOOOOOOOOOOOAXXXXXXXXGOOOOOOOOOOOOOOOOOOOOAGOOOOOOOOOOAOXXXXXXXXX,0,0,0
6573,244,10,234,149,207,0,0,442,333,109,GOOOOOOOOOOOOOOOOOOOOOGOOOOOOOOOOOOOOOOOOOOOGOOOOOOOOOOOOOXXXXXXXXGOOOOOOOOOOOOXXXXXXXXXGOOOOOOOOOOOOOOAOXXXXXGOOOOOOOOOOOOOOOOOAOOOGOOOOOOOOOOOOOOOAAOXXXGOOOOOOOOOOOOOOOOOOOOOGOOOOOOOOOOOOOOOOOOOOOGOOOOOOOOOOOOOOAOOAOOAGOOOOOOOOOOOOAXXXXXXXXGOOOOOOOOOOOOOOOOOOOOAGOOOOOOOOOOAOXXXXXXXXX,0,0,0
6594,245,10,235,151,204,0,0,441,339,102,GOOOOOOOOOOOOOOOOOOOOOGOOOOOOOOOOOOOOOOOOOOOGOOOOOOOOOOOOOXXXXXXXXGOOOOOOOOOOOOXXXXXXXXXGOOOOOOOOOOOOOOAOAXXXXGOOOOOOOOOOOOOOOOOAOOOGOOOOOOOOOOOOOOOAAOXXXGOOOOOOOOOOOOOOOOOOOOOGOOOOOOOOOOOOOOOOOOOOOGOOOOOOOOOOOOOOAOOAOOAGOOOOOOOOOOOOAXXXXXXXXGOOOOOOOOOOOOOOOOOOOOOGOOOOOOOOOOAOXXXXXXXXX,0,0,0

6615,245,9,236,151,204,0,0,442,343,99,GOOOOOOOOOOOOOOOOOOOOOGOOOOOOOOOOOOOOOOOOOOOGOOOOOOOOOOOOOXXXXXXXXGOOOOOOOOOOOOXXXXXXXXXGOOOOOOOOOOOOOOAOAXXXXGOOOOOOOOOOOOOOOOOAOOOGOOOOOOOOOOOOOOOAAOXXXGOOOOOOOOOOOOOOOOOOOOOGOOOOOOOOOOOOOOOOOOOOOGOOOOOOOOOOOOOOAOOOOOAGOOOOOOOOOOOOAXXXXXXXXGOOOOOOOOOOOOOOOOOOOOOGOOOOOOOOOOAOXXXXXXXXX,0,0,0
6636,245,9,236,154,201,0,0,436,343,93,GOOOOOOOOOOOOOOOOOOOOOGOOOOOOOOOOOOOOOOOOOOOGOOOOOOOOOOOOOXXXXXXXXGOOOOOOOOOOOOXXXXXXXXXGOOOOOOOOOOOOOOAOAXXXXGOOOOOOOOOOOOOOOOOAOOOGOOOOOOOOOOOOOOOAAOXXXGOOOOOOOOOOOOOOOOOOOOOGOOOOOOOOOOOOOOOOOOOOOGOOOOOOOOOOOOOOAOOOOOAGOOOOOOOOOOOOAXXXXXXXXGOOOOOOOOOOOOOOOOOOOOOGOOOOOOOOOOAOXXXXXXXXX,0,0,0
6657,245,9,236,153,202,0,0,438,343,95,GOOOOOOOOOOOOOOOOOOOOOGOOOOOOOOOOOOOOOOOOOOOGOOOOOOOOOOOOOXXXXXXXXGOOOOOOOOOOOOXXXXXXXXXGOOOOOOOOOOOOOOAOAXXXXGOOOOOOOOOOOOOOOOOAOOOGOOOOOOOOOOOOOOOAAOXXXGOOOOOOOOOOOOOOOOOOOOOGOOOOOOOOOOOOOOOOOOOOOGOOOOOOOOOOOOOOAOOOOOAGOOOOOOOOOOOOAXXXXXXXXGOOOOOOOOOOOOOOOOOOOOOGOOOOOOOOOOAOXXXXXXXXX,0,0,0
6678,245,9,236,152,203,0,0,440,348,92,GOOOOOOOOOOOOOOOOOOOOOGOOOOOOOOOOOOOOOOOOOOOGOOOOOOOOOOOOOXXXXXXXXGOOOOOOOOOOOOXXXXXXXXXGOOOOOOOOOOOOOOAOAXXXXGOOOOOOOOOOOOOOOOOAOOOGOOOOOOOOOOOOOOOAAOXXXGOOOOOOOOOOOOOOOOOOOOOGOOOOOOOOOOOOOOOOOOOOOGOOOOOOOOOOOOOOAOOOOOAGOOOOOOOOOOOOAXXXXXXXXGOOOOOOOOOOOOOOOOOOOOOGOOOOOOOOOOAOXXXXXXXXX,0,0,0
6699,250,14,236,148,202,0,0,439,345,94,GOOOOOOOOOOOOOOOOOOOOOGOOOOOOOOOOOOOOOOOOOOOGOOOOOOOOOOOOOXXXXXXXXGOOOOOOOOOOOOAAAAXXXXXGOOOOOOOOOOOOOOAOAXXXXGOOOOOOOOOOOOOOOOOAOOOGOOOOOOOOOOOOOOOAAOAXXGOOOOOOOOOOOOOOOOOOOOOGOOOOOOOOOOOOOOOOOOOOOGOOOOOOOOOOOOOOAOOOOOAGOOOOOOOOOOOOAXXXXXXXXGOOOOOOOOOOOOOOOOOOOOOGOOOOOOOOOOAOXXXXXXXXX,0,0,0

6720,250,14,236,148,202,0,0,439,353,86,GOOOOOOOOOOOOOOOOOOOOOGOOOOOOOOOOOOOOOOOOOOOGOOOOOOOOOOOOOXXXXXXXXGOOOOOOOOOOOOAAAAXXXXXGOOOOOOOOOOOOOOAOAXXXXGOOOOOOOOOOOOOOOOOAOOOGOOOOOOOOOOOOOOOAAOAXXGOOOOOOOOOOOOOOOOOOOOOGOOOOOOOOOOOOOOOOOOOOOGOOOOOOOOOOOOOOAOOOOOAGOOOOOOOOOOOOAXXXXXXXXGOOOOOOOOOOOOOOOOOOOOOGOOOOOOOOOOAOXXXXXXXXX,0,0,0
6741,250,12,238,154,196,0,0,435,349,86,GOOOOOOOOOOOOOOOOOOOOOGOOOOOOOOOOOOOOOOOOOOOGOOOOOOOOOOOOOXXXXXXXXGOOOOOOOOOOOOAAAAXXXXXGOOOOOOOOOOOOOOAOAXXXXGOOOOOOOOOOOOOOOOOAOOOGOOOOOOOOOOOOOOOOAOAXXGOOOOOOOOOOOOOOOOOOOOOGOOOOOOOOOOOOOOOOOOOOOGOOOOOOOOOOOOOOAOOOOOAGOOOOOOOOOOOOAXXXXXXXXGOOOOOOOOOOOOOOOOOOOOOGOOOOOOOOOOOOXXXXXXXXX,0,0,0
6762,250,12,238,158,192,0,0,431,347,84,GOOOOOOOOOOOOOOOOOOOOOGOOOOOOOOOOOOOOOOOOOOOGOOOOOOOOOOOOOXXXXXXXXGOOOOOOOOOOOOAAAAXXXXXGOOOOOOOOOOOOOOAOAXXXXGOOOOOOOOOOOOOOOOOAOOOGOOOOOOOOOOOOOOOOAOAXXGOOOOOOOOOOOOOOOOOOOOOGOOOOOOOOOOOOOOOOOOOOOGOOOOOOOOOOOOOOAOOOOOAGOOOOOOOOOOOOAXXXXXXXXGOOOOOOOOOOOOOOOOOOOOOGOOOOOOOOOOOOXXXXXXXXX,0,0,0
6783,250,12,238,159,191,0,0,429,354,75,GOOOOOOOOOOOOOOOOOOOOOGOOOOOOOOOOOOOOOOOOOOOGOOOOOOOOOOOOOXXXXXXXXGOOOOOOOOOOOOAAAAXXXXXGOOOOOOOOOOOOOOAOAXXXXGOOOOOOOOOOOOOOOOOAOOOGOOOOOOOOOOOOOOOOAOAXXGOOOOOOOOOOOOOOOOOOOOOGOOOOOOOOOOOOOOOOOOOOOGOOOOOOOOOOOOOOAOOOOOAGOOOOOOOOOOOOAXXXXXXXXGOOOOOOOOOOOOOOOOOOOOOGOOOOOOOOOOOOXXXXXXXXX,0,0,0
6804,250,12,238,160,190,0,0,429,356,73,GOOOOOOOOOOOOOOOOOOOOOGOOOOOOOOOOOOOOOOOOOOOGOOOOOOOOOOOOOXXXXXXXXGOOOOOOOOOOOOAAAAXXXXXGOOOOOOOOOOOOOOAOAXXXXGOOOOOOOOOOOOOOOOOAOOOGOOOOOOOOOOOOOOOOAOAXXGOOOOOOOOOOOOOOOOOOOOOGOOOOOOOOOOOOOOOOOOOOOGOOOOOOOOOOOOOOAOOOOOAGOOOOOOOOOOOOAXXXXXXXXGOOOOOOOOOOOOOOOOOOOOOGOOOOOOOOOOOOXXXXXXXXX,0,0,0

6825,250,11,239,161,189,0,0,429,359,70,GOOOOOOOOOOOOOOOOOOOOOGOOOOOOOOOOOOOOOOOOOOOGOOOOOOOOOOOOOXXXXXXXXGOOOOOOOOOOOOAAAAXXXXXGOOOOOOOOOOOOOOAOAXXXXGOOOOOOOOOOOOOOOOOAOOOGOOOOOOOOOOOOOOOOAOAXXGOOOOOOOOOOOOOOOOOOOOOGOOOOOOOOOOOOOOOOOOOOOGOOOOOOOOOOOOOOAOOOOOOGOOOOOOOOOOOOAXXXXXXXXGOOOOOOOOOOOOOOOOOOOOOGOOOOOOOOOOOOXXXXXXXXX,0,0,0
6846,250,11,239,163,187,0,0,427,357,70,GOOOOOOOOOOOOOOOOOOOOOGOOOOOOOOOOOOOOOOOOOOOGOOOOOOOOOOOOOXXXXXXXXGOOOOOOOOOOOOAAAAXXXXXGOOOOOOOOOOOOOOAOAXXXXGOOOOOOOOOOOOOOOOOAOOOGOOOOOOOOOOOOOOOOAOAXXGOOOOOOOOOOOOOOOOOOOOOGOOOOOOOOOOOOOOOOOOOOOGOOOOOOOOOOOOOOAOOOOOOGOOOOOOOOOOOOAXXXXXXXXGOOOOOOOOOOOOOOOOOOOOOGOOOOOOOOOOOOXXXXXXXXX,0,0,0
6867,250,11,239,162,188,0,0,428,354,74,GOOOOOOOOOOOOOOOOOOOOOGOOOOOOOOOOOOOOOOOOOOOGOOOOOOOOOOOOOXXXXXXXXGOOOOOOOOOOOOAAAAXXXXXGOOOOOOOOOOOOOOAOAXXXXGOOOOOOOOOOOOOOOOOAOOOGOOOOOOOOOOOOOOOOAOAXXGOOOOOOOOOOOOOOOOOOOOOGOOOOOOOOOOOOOOOOOOOOOGOOOOOOOOOOOOOOAOOOOOOGOOOOOOOOOOOOAXXXXXXXXGOOOOOOOOOOOOOOOOOOOOOGOOOOOOOOOOOOXXXXXXXXX,0,0,0
6888,250,11,239,167,183,0,0,423,354,69,GOOOOOOOOOOOOOOOOOOOOOGOOOOOOOOOOOOOOOOOOOOOGOOOOOOOOOOOOOXXXXXXXXGOOOOOOOOOOOOAAAAXXXXXGOOOOOOOOOOOOOOAOAXXXXGOOOOOOOOOOOOOOOOOAOOOGOOOOOOOOOOOOOOOOAOAXXGOOOOOOOOOOOOOOOOOOOOOGOOOOOOOOOOOOOOOOOOOOOGOOOOOOOOOOOOOOAOOOOOOGOOOOOOOOOOOOAXXXXXXXXGOOOOOOOOOOOOOOOOOOOOOGOOOOOOOOOOOOXXXXXXXXX,0,0,0
6909,251,12,239,166,183,0,0,423,356,67,GOOOOOOOOOOOOOOOOOOOOOGOOOOOOOOOOOOOOOOOOOOOGOOOOOOOOOOOOOXXXXXXXXGOOOOOOOOOOOOAAAAXXXXXGOOOOOOOOOOOOOOAOAAXXXGOOOOOOOOOOOOOOOOOAOOOGOOOOOOOOOOOOOOOOAOAXXGOOOOOOOOOOOOOOOOOOOOOGOOOOOOOOOOOOOOOOOOOOOGOOOOOOOOOOOOOOAOOOOOOGOOOOOOOOOOOOAXXXXXXXXGOOOOOOOOOOOOOOOOOOOOOGOOOOOOOOOOOOXXXXXXXXX,0,0,0

6930,251,12,239,164,185,0,0,425,360,65,GOOOOOOOOOOOOOOOOOOOOOGOOOOOOOOOOOOOOOOOOOOOGOOOOOOOOOOOOOXXXXXXXXGOOOOOOOOOOOOAAAAXXXXXGOOOOOOOOOOOOOOAOAAXXXGOOOOOOOOOOOOOOOOOAOOOGOOOOOOOOOOOOOOOOAOAXXGOOOOOOOOOOOOOOOOOOOOOGOOOOOOOOOOOOOOOOOOOOOGOOOOOOOOOOOOOOAOOOOOOGOOOOOOOOOOOOAXXXXXXXXGOOOOOOOOOOOOOOOOOOOOOGOOOOOOOOOOOOXXXXXXXXX,0,0,0
6951,251,12,239,165,184,0,0,424,358,66,GOOOOOOOOOOOOOOOOOOOOOGOOOOOOOOOOOOOOOOOOOOOGOOOOOOOOOOOOOXXXXXXXXGOOOOOOOOOOOOAAAAXXXXXGOOOOOOOOOOOOOOAOAAXXXGOOOOOOOOOOOOOOOOOAOOOGOOOOOOOOOOOOOOOOAOAXXGOOOOOOOOOOOOOOOOOOOOOGOOOOOOOOOOOOOOOOOOOOOGOOOOOOOOOOOOOOAOOOOOOGOOOOOOOOOOOOAXXXXXXXXGOOOOOOOOOOOOOOOOOOOOOGOOOOOOOOOOOOXXXXXXXXX,0,0,0
6972,251,12,239,164,185,0,0,425,362,63,GOOOOOOOOOOOOOOOOOOOOOGOOOOOOOOOOOOOOOOOOOOOGOOOOOOOOOOOOOXXXXXXXXGOOOOOOOOOOOOAAAAXXXXXGOOOOOOOOOOOOOOAOAAXXXGOOOOOOOOOOOOOOOOOAOOOGOOOOOOOOOOOOOOOOAOAXXGOOOOOOOOOOOOOOOOOOOOOGOOOOOOOOOOOOOOOOOOOOOGOOOOOOOOOOOOOOAOOOOOOGOOOOOOOOOOOOAXXXXXXXXGOOOOOOOOOOOOOOOOOOOOOGOOOOOOOOOOOOXXXXXXXXX,0,0,0
6993,252,12,240,162,186,0,0,427,358,69,GOOOOOOOOOOOOOOOOOOOOOGOOOOOOOOOOOOOOOOOOOOOGOOOOOOOOOOOOOXXXXXXXXGOOOOOOOOOOOOAOAAXXXXXGOOOOOOOOOOOOOOAOAAXXXGOOOOOOOOOOOOOOOOOAOOOGOOOOOOOOOOOOOOOOAOAAXGOOOOOOOOOOOOOOOOOOOOOGOOOOOOOOOOOOOOOOOOOOOGOOOOOOOOOOOOOOAOOOOOOGOOOOOOOOOOOOAXXXXXXXXGOOOOOOOOOOOOOOOOOOOOOGOOOOOOOOOOOOXXXXXXXXX,0,0,0
7014,252,12,240,160,188,0,0,429,357,72,GOOOOOOOOOOOOOOOOOOOOOGOOOOOOOOOOOOOOOOOOOOOGOOOOOOOOOOOOOXXXXXXXXGOOOOOOOOOOOOAOAAXXXXXGOOOOOOOOOOOOOOAOAAXXXGOOOOOOOOOOOOOOOOOAOOOGOOOOOOOOOOOOOOOOAOAAXGOOOOOOOOOOOOOOOOOOOOOGOOOOOOOOOOOOOOOOOOOOOGOOOOOOOOOOOOOOAOOOOOOGOOOOOOOOOOOOAXXXXXXXXGOOOOOOOOOOOOOOOOOOOOOGOOOOOOOOOOOOXXXXXXXXX,0,0,0

7035,252,12,240,163,185,0,0,427,353,74,GOOOOOOOOOOOOOOOOOOOOOGOOOOOOOOOOOOOOOOOOOOOGOOOOOOOOOOOOOXXXXXXXXGOOOOOOOOOOOOAOAAXXXXXGOOOOOOOOOOOOOOAOAAXXXGOOOOOOOOOOOOOOOOOAOOOGOOOOOOOOOOOOOOOOAOAAXGOOOOOOOOOOOOOOOOOOOOOGOOOOOOOOOOOOOOOOOOOOOGOOOOOOOOOOOOOOAOOOOOOGOOOOOOOOOOOOAXXXXXXXXGOOOOOOOOOOOOOOOOOOOOOGOOOOOOOOOOOOXXXXXXXXX,0,0,0
7056,253,12,241,159,188,0,0,431,359,72,GOOOOOOOOOOOOOOOOOOOOOGOOOOOOOOOOOOOOOOOOOOOGOOOOOOOOOOOOOXXXXXXXXGOOOOOOOOOOOOAOAAAXXXXGOOOOOOOOOOOOOOOOAAXXXGOOOOOOOOOOOOOOOOOAOOOGOOOOOOOOOOOOOOOOAOAAXGOOOOOOOOOOOOOOOOOOOOOGOOOOOOOOOOOOOOOOOOOOOGOOOOOOOOOOOOOOAOOOOOOGOOOOOOOOOOOOAXXXXXXXXGOOOOOOOOOOOOOOOOOOOOOGOOOOOOOOOOOOXXXXXXXXX,0,0,0
7077,254,13,241,156,190,0,0,431,357,74,GOOOOOOOOOOOOOOOOOOOOOGOOOOOOOOOOOOOOOOOOOOOGOOOOOOOOOOOOOXXXXXXXXGOOOOOOOOOOOOAOAAAXXXXGOOOOOOOOOOOOOOOOAAXXXGOOOOOOOOOOOOOOOOOAOOOGOOOOOOOOOOOOOOOOAOAAAGOOOOOOOOOOOOOOOOOOOOOGOOOOOOOOOOOOOOOOOOOOOGOOOOOOOOOOOOOOAOOOOOOGOOOOOOOOOOOOAXXXXXXXXGOOOOOOOOOOOOOOOOOOOOOGOOOOOOOOOOOOXXXXXXXXX,0,0,0
7098,255,14,241,160,185,0,0,428,353,75,GOOOOOOOOOOOOOOOOOOOOOGOOOOOOOOOOOOOOOOOOOOOGOOOOOOOOOOOOOXXXXXXXXGOOOOOOOOOOOOAOAAAXXXXGOOOOOOOOOOOOOOOOAAXXXGOOOOOOOOOOOOOOOOOAOOOGOOOOOOOOOOOOOOOOAOAAAGOOOOOOOOOOOOOOOOOOOOOGOOOOOOOOOOOOOOOOOOOOOGOOOOOOOOOOOOOOAOOOOOOGOOOOOOOOOOOOAXXXXXXXXGOOOOOOOOOOOOOOOOOOOOOGOOOOOOOOOOOOAXXXXXXXX,0,0,0
7119,256,15,241,158,186,0,0,429,362,67,GOOOOOOOOOOOOOOOOOOOOOGOOOOOOOOOOOOOOOOOOOOOGOOOOOOOOOOOOOXXXXXXXXGOOOOOOOOOOOOAOAAAXXXXGOOOOOOOOOOOOOOOOAAXXXGOOOOOOOOOOOOOOOOOAOOOGOOOOOOOOOOOOOOOOAOAAAGOOOOOOOOOOOOOOOOOOOOOGOOOOOOOOOOOOOOOOOOOOOGOOOOOOOOOOOOOOAOOOOOOGOOOOOOOOOOOOAXXXXXXXXGOOOOOOOOOOOOOOOOOOOOOGOOOOOOOOOOOOAAXXXXXXX,0,0,0

7140,256,14,242,157,187,0,0,430,363,67,GOOOOOOOOOOOOOOOOOOOOOGOOOOOOOOOOOOOOOOOOOOOGOOOOOOOOOOOOOXXXXXXXXGOOOOOOOOOOOOAOAAAXXXXGOOOOOOOOOOOOOOOOAAXXXGOOOOOOOOOOOOOOOOOAOOOGOOOOOOOOOOOOOOOOAOAAAGOOOOOOOOOOOOOOOOOOOOOGOOOOOOOOOOOOOOOOOOOOOGOOOOOOOOOOOOOOOOOOOOOGOOOOOOOOOOOOAXXXXXXXXGOOOOOOOOOOOOOOOOOOOOOGOOOOOOOOOOOOAAXXXXXXX,0,0,0
7161,256,13,243,160,184,0,0,428,363,65,GOOOOOOOOOOOOOOOOOOOOOGOOOOOOOOOOOOOOOOOOOOOGOOOOOOOOOOOOOXXXXXXXXGOOOOOOOOOOOOAOAAAXXXXGOOOOOOOOOOOOOOOOAAXXXGOOOOOOOOOOOOOOOOOAOOOGOOOOOOOOOOOOOOOOAOAAAGOOOOOOOOOOOOOOOOOOOOOGOOOOOOOOOOOOOOOOOOOOOGOOOOOOOOOOOOOOOOOOOOOGOOOOOOOOOOOOOXXXXXXXXGOOOOOOOOOOOOOOOOOOOOOGOOOOOOOOOOOOAAXXXXXXX,0,0,0
7182,257,13,244,165,178,0,0,423,356,67,GOOOOOOOOOOOOOOOOOOOOOGOOOOOOOOOOOOOOOOOOOOOGOOOOOOOOOOOOOXXXXXXXXGOOOOOOOOOOOOAOAAAAXXXGOOOOOOOOOOOOOOOOAAXXXGOOOOOOOOOOOOOOOOOOOOOGOOOOOOOOOOOOOOOOAOAAAGOOOOOOOOOOOOOOOOOOOOOGOOOOOOOOOOOOOOOOOOOOOGOOOOOOOOOOOOOOOOOOOOOGOOOOOOOOOOOOOXXXXXXXXGOOOOOOOOOOOOOOOOOOOOOGOOOOOOOOOOOOAAXXXXXXX,0,0,0
7203,257,12,245,164,179,0,0,424,355,69,GOOOOOOOOOOOOOOOOOOOOOGOOOOOOOOOOOOOOOOOOOOOGOOOOOOOOOOOOOXXXXXXXXGOOOOOOOOOOOOAOAOAAXXXGOOOOOOOOOOOOOOOOAAXXXGOOOOOOOOOOOOOOOOOOOOOGOOOOOOOOOOOOOOOOAOAAAGOOOOOOOOOOOOOOOOOOOOOGOOOOOOOOOOOOOOOOOOOOOGOOOOOOOOOOOOOOOOOOOOOGOOOOOOOOOOOOOXXXXXXXXGOOOOOOOOOOOOOOOOOOOOOGOOOOOOOOOOOOAAXXXXXXX,0,0,0
7224,257,12,245,167,176,0,0,422,349,73,GOOOOOOOOOOOOOOOOOOOOOGOOOOOOOOOOOOOOOOOOOOOGOOOOOOOOOOOOOXXXXXXXXGOOOOOOOOOOOOAOAOAAXXXGOOOOOOOOOOOOOOOOAAXXXGOOOOOOOOOOOOOOOOOOOOOGOOOOOOOOOOOOOOOOAOAAAGOOOOOOOOOOOOOOOOOOOOOGOOOOOOOOOOOOOOOOOOOOOGOOOOOOOOOOOOOOOOOOOOOGOOOOOOOOOOOOOXXXXXXXXGOOOOOOOOOOOOOOOOOOOOOGOOOOOOOOOOOOAAXXXXXXX,0,0,0

7245,257,12,245,163,180,0,0,426,352,74,GOOOOOOOOOOOOOOOOOOOOOGOOOOOOOOOOOOOOOOOOOOOGOOOOOOOOOOOOOXXXXXXXXGOOOOOOOOOOOOAOAOAAXXXGOOOOOOOOOOOOOOOOAAXXXGOOOOOOOOOOOOOOOOOOOOOGOOOOOOOOOOOOOOOOAOAAAGOOOOOOOOOOOOOOOOOOOOOGOOOOOOOOOOOOOOOOOOOOOGOOOOOOOOOOOOOOOOOOOOOGOOOOOOOOOOOOOXXXXXXXXGOOOOOOOOOOOOOOOOOOOOOGOOOOOOOOOOOOAAXXXXXXX,0,0,0
7266,257,12,245,164,179,0,0,425,354,71,GOOOOOOOOOOOOOOOOOOOOOGOOOOOOOOOOOOOOOOOOOOOGOOOOOOOOOOOOOXXXXXXXXGOOOOOOOOOOOOAOAOAAXXXGOOOOOOOOOOOOOOOOAAXXXGOOOOOOOOOOOOOOOOOOOOOGOOOOOOOOOOOOOOOOAOAAAGOOOOOOOOOOOOOOOOOOOOOGOOOOOOOOOOOOOOOOOOOOOGOOOOOOOOOOOOOOOOOOOOOGOOOOOOOOOOOOOXXXXXXXXGOOOOOOOOOOOOOOOOOOOOOGOOOOOOOOOOOOAAXXXXXXX,0,0,0
7287,257,10,247,164,179,0,0,428,360,68,GOOOOOOOOOOOOOOOOOOOOOGOOOOOOOOOOOOOOOOOOOOOGOOOOOOOOOOOOOXXXXXXXXGOOOOOOOOOOOOAOAOAAXXXGOOOOOOOOOOOOOOOOAAXXXGOOOOOOOOOOOOOOOOOOOOOGOOOOOOOOOOOOOOOOOOAAAGOOOOOOOOOOOOOOOOOOOOOGOOOOOOOOOOOOOOOOOOOOOGOOOOOOOOOOOOOOOOOOOOOGOOOOOOOOOOOOOXXXXXXXXGOOOOOOOOOOOOOOOOOOOOOGOOOOOOOOOOOOOAXXXXXXX,0,0,0
7308,258,11,247,166,176,0,0,425,360,65,GOOOOOOOOOOOOOOOOOOOOOGOOOOOOOOOOOOOOOOOOOOOGOOOOOOOOOOOOOXXXXXXXXGOOOOOOOOOOOOAOAOAAXXXGOOOOOOOOOOOOOOOOAAXXXGOOOOOOOOOOOOOOOOOOOOOGOOOOOOOOOOOOOOOOOOAAAGOOOOOOOOOOOOOOOOOOOOOGOOOOOOOOOOOOOOOOOOOOOGOOOOOOOOOOOOOOOOOOOOOGOOOOOOOOOOOOOAXXXXXXXGOOOOOOOOOOOOOOOOOOOOOGOOOOOOOOOOOOOAXXXXXXX,0,0,0
7329,259,12,247,165,176,0,0,425,360,65,GOOOOOOOOOOOOOOOOOOOOOGOOOOOOOOOOOOOOOOOOOOOGOOOOOOOOOOOOOXXXXXXXXGOOOOOOOOOOOOAOAOAAXXXGOOOOOOOOOOOOOOOOAAXXXGOOOOOOOOOOOOOOOOOOOOOGOOOOOOOOOOOOOOOOOOAAAGOOOOOOOOOOOOOOOOOOOOOGOOOOOOOOOOOOOOOOOOOOOGOOOOOOOOOOOOOOOOOOOOOGOOOOOOOOOOOOOAAXXXXXXGOOOOOOOOOOOOOOOOOOOOOGOOOOOOOOOOOOOAXXXXXXX,0,0,0

7350,260,13,247,160,180,0,0,429,364,65,GOOOOOOOOOOOOOOOOOOOOOGOOOOOOOOOOOOOOOOOOOOOGOOOOOOOOOOOOOAXXXXXXXGOOOOOOOOOOOOAOAOAAXXXGOOOOOOOOOOOOOOOOAAXXXGOOOOOOOOOOOOOOOOOOOOOGOOOOOOOOOOOOOOOOOOAAAGOOOOOOOOOOOOOOOOOOOOOGOOOOOOOOOOOOOOOOOOOOOGOOOOOOOOOOOOOOOOOOOOOGOOOOOOOOOOOOOAAXXXXXXGOOOOOOOOOOOOOOOOOOOOOGOOOOOOOOOOOOOAXXXXXXX,0,0,0
7371,261,14,247,161,178,0,0,426,364,62,GOOOOOOOOOOOOOOOOOOOOOGOOOOOOOOOOOOOOOOOOOOOGOOOOOOOOOOOOOAAXXXXXXGOOOOOOOOOOOOAOAOAAXXXGOOOOOOOOOOOOOOOOAAXXXGOOOOOOOOOOOOOOOOOOOOOGOOOOOOOOOOOOOOOOOOAAAGOOOOOOOOOOOOOOOOOOOOOGOOOOOOOOOOOOOOOOOOOOOGOOOOOOOOOOOOOOOOOOOOOGOOOOOOOOOOOOOAAXXXXXXGOOOOOOOOOOOOOOOOOOOOOGOOOOOOOOOOOOOAXXXXXXX,0,0,0
7392,261,13,248,162,177,0,0,427,366,61,GOOOOOOOOOOOOOOOOOOOOOGOOOOOOOOOOOOOOOOOOOOOGOOOOOOOOOOOOOAAXXXXXXGOOOOOOOOOOOOAOAOAOXXXGOOOOOOOOOOOOOOOOAAXXXGOOOOOOOOOOOOOOOOOOOOOGOOOOOOOOOOOOOOOOOOAAAGOOOOOOOOOOOOOOOOOOOOOGOOOOOOOOOOOOOOOOOOOOOGOOOOOOOOOOOOOOOOOOOOOGOOOOOOOOOOOOOAAXXXXXXGOOOOOOOOOOOOOOOOOOOOOGOOOOOOOOOOOOOAXXXXXXX,0,0,0
7413,261,13,248,162,177,0,0,427,367,60,GOOOOOOOOOOOOOOOOOOOOOGOOOOOOOOOOOOOOOOOOOOOGOOOOOOOOOOOOOAAXXXXXXGOOOOOOOOOOOOAOAOAOXXXGOOOOOOOOOOOOOOOOAAXXXGOOOOOOOOOOOOOOOOOOOOOGOOOOOOOOOOOOOOOOOOAAAGOOOOOOOOOOOOOOOOOOOOOGOOOOOOOOOOOOOOOOOOOOOGOOOOOOOOOOOOOOOOOOOOOGOOOOOOOOOOOOOAAXXXXXXGOOOOOOOOOOOOOOOOOOOOOGOOOOOOOOOOOOOAXXXXXXX,0,0,0
7434,262,14,248,159,179,0,0,428,368,60,GOOOOOOOOOOOOOOOOOOOOOGOOOOOOOOOOOOOOOOOOOOOGOOOOOOOOOOOOOAAXXXXXXGOOOOOOOOOOOOAOAOAOAXXGOOOOOOOOOOOOOOOOAAXXXGOOOOOOOOOOOOOOOOOOOOOGOOOOOOOOOOOOOOOOOOAAAGOOOOOOOOOOOOOOOOOOOOOGOOOOOOOOOOOOOOOOOOOOOGOOOOOOOOOOOOOOOOOOOOOGOOOOOOOOOOOOOAAXXXXXXGOOOOOOOOOOOOOOOOOOOOOGOOOOOOOOOOOOOAXXXXXXX,0,0,0

7455,263,15,248,161,176,0,0,426,364,62,GOOOOOOOOOOOOOOOOOOOOOGOOOOOOOOOOOOOOOOOOOOOGOOOOOOOOOOOOOAAXXXXXXGOOOOOOOOOOOOAOAOAOAXXGOOOOOOOOOOOOOOOOAAXXXGOOOOOOOOOOOOOOOOOOOOOGOOOOOOOOOOOOOOOOOOAAAGOOOOOOOOOOOOOOOOOOOOOGOOOOOOOOOOOOOOOOOOOOOGOOOOOOOOOOOOOOOOOOOOOGOOOOOOOOOOOOOAAXXXXXXGOOOOOOOOOOOOOOOOOOOOOGOOOOOOOOOOOOOAAXXXXXX,0,0,0
7476,264,16,248,157,179,0,0,426,364,62,GOOOOOOOOOOOOOOOOOOOOOGOOOOOOOOOOOOOOOOOOOOOGOOOOOOOOOOOOOAAXXXXXXGOOOOOOOOOOOOAOAOAOAXXGOOOOOOOOOOOOOOOOAAAXXGOOOOOOOOOOOOOOOOOOOOOGOOOOOOOOOOOOOOOOOOAAAGOOOOOOOOOOOOOOOOOOOOOGOOOOOOOOOOOOOOOOOOOOOGOOOOOOOOOOOOOOOOOOOOOGOOOOOOOOOOOOOAAXXXXXXGOOOOOOOOOOOOOOOOOOOOOGOOOOOOOOOOOOOAAXXXXXX,0,0,0
7497,264,16,248,160,176,0,0,425,361,64,GOOOOOOOOOOOOOOOOOOOOOGOOOOOOOOOOOOOOOOOOOOOGOOOOOOOOOOOOOAAXXXXXXGOOOOOOOOOOOOAOAOAOAXXGOOOOOOOOOOOOOOOOAAAXXGOOOOOOOOOOOOOOOOOOOOOGOOOOOOOOOOOOOOOOOOAAAGOOOOOOOOOOOOOOOOOOOOOGOOOOOOOOOOOOOOOOOOOOOGOOOOOOOOOOOOOOOOOOOOOGOOOOOOOOOOOOOAAXXXXXXGOOOOOOOOOOOOOOOOOOOOOGOOOOOOOOOOOOOAAXXXXXX,0,0,0
7518,264,16,248,157,179,0,0,428,359,69,GOOOOOOOOOOOOOOOOOOOOOGOOOOOOOOOOOOOOOOOOOOOGOOOOOOOOOOOOOAAXXXXXXGOOOOOOOOOOOOAOAOAOAXXGOOOOOOOOOOOOOOOOAAAXXGOOOOOOOOOOOOOOOOOOOOOGOOOOOOOOOOOOOOOOOOAAAGOOOOOOOOOOOOOOOOOOOOOGOOOOOOOOOOOOOOOOOOOOOGOOOOOOOOOOOOOOOOOOOOOGOOOOOOOOOOOOOAAXXXXXXGOOOOOOOOOOOOOOOOOOOOOGOOOOOOOOOOOOOAAXXXXXX,0,0,0
7539,264,16,248,156,180,0,0,429,360,69,GOOOOOOOOOOOOOOOOOOOOOGOOOOOOOOOOOOOOOOOOOOOGOOOOOOOOOOOOOAAXXXXXXGOOOOOOOOOOOOAOAOAOAXXGOOOOOOOOOOOOOOOOAAAXXGOOOOOOOOOOOOOOOOOOOOOGOOOOOOOOOOOOOOOOOOAAAGOOOOOOOOOOOOOOOOOOOOOGOOOOOOOOOOOOOOOOOOOOOGOOOOOOOOOOOOOOOOOOOOOGOOOOOOOOOOOOOAAXXXXXXGOOOOOOOOOOOOOOOOOOOOOGOOOOOOOOOOOOOAAXXXXXX,0,0,0

7560,264,16,248,161,175,0,0,424,357,67,GOOOOOOOOOOOOOOOOOOOOOGOOOOOOOOOOOOOOOOOOOOOGOOOOOOOOOOOOOAAXXXXXXGOOOOOOOOOOOOAOAOAOAXXGOOOOOOOOOOOOOOOOAAAXXGOOOOOOOOOOOOOOOOOOOOOGOOOOOOOOOOOOOOOOOOAAAGOOOOOOOOOOOOOOOOOOOOOGOOOOOOOOOOOOOOOOOOOOOGOOOOOOOOOOOOOOOOOOOOOGOOOOOOOOOOOOOAAXXXXXXGOOOOOOOOOOOOOOOOOOOOOGOOOOOOOOOOOOOAAXXXXXX,0,0,0
7581,264,15,249,159,177,0,0,425,357,68,GOOOOOOOOOOOOOOOOOOOOOGOOOOOOOOOOOOOOOOOOOOOGOOOOOOOOOOOOOAAXXXXXXGOOOOOOOOOOOOAOAOAOAXXGOOOOOOOOOOOOOOOOAAAXXGOOOOOOOOOOOOOOOOOOOOOGOOOOOOOOOOOOOOOOOOAAAGOOOOOOOOOOOOOOOOOOOOOGOOOOOOOOOOOOOOOOOOOOOGOOOOOOOOOOOOOOOOOOOOOGOOOOOOOOOOOOOOAXXXXXXGOOOOOOOOOOOOOOOOOOOOOGOOOOOOOOOOOOOAAXXXXXX,0,0,0
7602,264,15,249,157,179,0,0,429,360,69,GOOOOOOOOOOOOOOOOOOOOOGOOOOOOOOOOOOOOOOOOOOOGOOOOOOOOOOOOOAAXXXXXXGOOOOOOOOOOOOAOAOAOAXXGOOOOOOOOOOOOOOOOAAAXXGOOOOOOOOOOOOOOOOOOOOOGOOOOOOOOOOOOOOOOOOAAAGOOOOOOOOOOOOOOOOOOOOOGOOOOOOOOOOOOOOOOOOOOOGOOOOOOOOOOOOOOOOOOOOOGOOOOOOOOOOOOOOAXXXXXXGOOOOOOOOOOOOOOOOOOOOOGOOOOOOOOOOOOOAAXXXXXX,0,0,0
7623,264,15,249,155,181,0,0,432,360,72,GOOOOOOOOOOOOOOOOOOOOOGOOOOOOOOOOOOOOOOOOOOOGOOOOOOOOOOOOOAAXXXXXXGOOOOOOOOOOOOAOAOAOAXXGOOOOOOOOOOOOOOOOAAAXXGOOOOOOOOOOOOOOOOOOOOOGOOOOOOOOOOOOOOOOOOAAAGOOOOOOOOOOOOOOOOOOOOOGOOOOOOOOOOOOOOOOOOOOOGOOOOOOOOOOOOOOOOOOOOOGOOOOOOOOOOOOOOAXXXXXXGOOOOOOOOOOOOOOOOOOOOOGOOOOOOOOOOOOOAAXXXXXX,0,0,0
7644,265,15,250,149,186,0,0,437,362,75,GOOOOOOOOOOOOOOOOOOOOOGOOOOOOOOOOOOOOOOOOOOOGOOOOOOOOOOOOOAOAXXXXXGOOOOOOOOOOOOAOAOAOAXXGOOOOOOOOOOOOOOOOAAAXXGOOOOOOOOOOOOOOOOOOOOOGOOOOOOOOOOOOOOOOOOAAAGOOOOOOOOOOOOOOOOOOOOOGOOOOOOOOOOOOOOOOOOOOOGOOOOOOOOOOOOOOOOOOOOOGOOOOOOOOOOOOOOAXXXXXXGOOOOOOOOOOOOOOOOOOOOOGOOOOOOOOOOOOOAAXXXXXX,0,0,0

7665,265,13,252,148,187,0,0,439,364,75,GOOOOOOOOOOOOOOOOOOOOOGOOOOOOOOOOOOOOOOOOOOOGOOOOOOOOOOOOOAOAXXXXXGOOOOOOOOOOOOAOAOAOAXXGOOOOOOOOOOOOOOOOOAAXXGOOOOOOOOOOOOOOOOOOOOOGOOOOOOOOOOOOOOOOOOAAOGOOOOOOOOOOOOOOOOOOOOOGOOOOOOOOOOOOOOOOOOOOOGOOOOOOOOOOOOOOOOOOOOOGOOOOOOOOOOOOOOAXXXXXXGOOOOOOOOOOOOOOOOOOOOOGOOOOOOOOOOOOOAAXXXXXX,0,0,0
7686,265,13,252,146,189,0,0,443,365,78,GOOOOOOOOOOOOOOOOOOOOOGOOOOOOOOOOOOOOOOOOOOOGOOOOOOOOOOOOOAOAXXXXXGOOOOOOOOOOOOAOAOAOAXXGOOOOOOOOOOOOOOOOOAAXXGOOOOOOOOOOOOOOOOOOOOOGOOOOOOOOOOOOOOOOOOAAOGOOOOOOOOOOOOOOOOOOOOOGOOOOOOOOOOOOOOOOOOOOOGOOOOOOOOOOOOOOOOOOOOOGOOOOOOOOOOOOOOAXXXXXXGOOOOOOOOOOOOOOOOOOOOOGOOOOOOOOOOOOOAAXXXXXX,0,0,0
7707,265,11,254,150,185,0,0,440,364,76,GOOOOOOOOOOOOOOOOOOOOOGOOOOOOOOOOOOOOOOOOOOOGOOOOOOOOOOOOOAOAXXXXXGOOOOOOOOOOOOAOAOAOAXXGOOOOOOOOOOOOOOOOOAOXXGOOOOOOOOOOOOOOOOOOOOOGOOOOOOOOOOOOOOOOOOAAOGOOOOOOOOOOOOOOOOOOOOOGOOOOOOOOOOOOOOOOOOOOOGOOOOOOOOOOOOOOOOOOOOOGOOOOOOOOOOOOOOOXXXXXXGOOOOOOOOOOOOOOOOOOOOOGOOOOOOOOOOOOOAAXXXXXX,0,0,0
7728,265,10,255,148,187,0,0,444,366,78,GOOOOOOOOOOOOOOOOOOOOOGOOOOOOOOOOOOOOOOOOOOOGOOOOOOOOOOOOOAOAXXXXXGOOOOOOOOOOOOAOOOAOAXXGOOOOOOOOOOOOOOOOOAOXXGOOOOOOOOOOOOOOOOOOOOOGOOOOOOOOOOOOOOOOOOAAOGOOOOOOOOOOOOOOOOOOOOOGOOOOOOOOOOOOOOOOOOOOOGOOOOOOOOOOOOOOOOOOOOOGOOOOOOOOOOOOOOOXXXXXXGOOOOOOOOOOOOOOOOOOOOOGOOOOOOOOOOOOOAAXXXXXX,0,0,0
7749,265,9,256,148,187,0,0,444,366,78,GOOOOOOOOOOOOOOOOOOOOOGOOOOOOOOOOOOOOOOOOOOOGOOOOOOOOOOOOOAOAXXXXXGOOOOOOOOOOOOAOOOAOOXXGOOOOOOOOOOOOOOOOOAOXXGOOOOOOOOOOOOOOOOOOOOOGOOOOOOOOOOOOOOOOOOAAOGOOOOOOOOOOOOOOOOOOOOOGOOOOOOOOOOOOOOOOOOOOOGOOOOOOOOOOOOOOOOOOOOOGOOOOOOOOOOOOOOOXXXXXXGOOOOOOOOOOOOOOOOOOOOOGOOOOOOOOOOOOOAAXXXXXX,0,0,0

7770,265,9,256,148,187,0,0,444,362,82,GOOOOOOOOOOOOOOOOOOOOOGOOOOOOOOOOOOOOOOOOOOOGOOOOOOOOOOOOOAOAXXXXXGOOOOOOOOOOOOAOOOAOOXXGOOOOOOOOOOOOOOOOOAOXXGOOOOOOOOOOOOOOOOOOOOOGOOOOOOOOOOOOOOOOOOAAOGOOOOOOOOOOOOOOOOOOOOOGOOOOOOOOOOOOOOOOOOOOOGOOOOOOOOOOOOOOOOOOOOOGOOOOOOOOOOOOOOOXXXXXXGOOOOOOOOOOOOOOOOOOOOOGOOOOOOOOOOOOOAAXXXXXX,0,0,0
7791,265,8,257,149,186,0,0,444,361,83,GOOOOOOOOOOOOOOOOOOOOOGOOOOOOOOOOOOOOOOOOOOOGOOOOOOOOOOOOOAOAXXXXXGOOOOOOOOOOOOAOOOAOOXXGOOOOOOOOOOOOOOOOOOOXXGOOOOOOOOOOOOOOOOOOOOOGOOOOOOOOOOOOOOOOOOAAOGOOOOOOOOOOOOOOOOOOOOOGOOOOOOOOOOOOOOOOOOOOOGOOOOOOOOOOOOOOOOOOOOOGOOOOOOOOOOOOOOOXXXXXXGOOOOOOOOOOOOOOOOOOOOOGOOOOOOOOOOOOOAAXXXXXX,0,0,0
7812,265,8,257,147,188,0,0,446,366,80,GOOOOOOOOOOOOOOOOOOOOOGOOOOOOOOOOOOOOOOOOOOOGOOOOOOOOOOOOOAOAXXXXXGOOOOOOOOOOOOAOOOAOOXXGOOOOOOOOOOOOOOOOOOOXXGOOOOOOOOOOOOOOOOOOOOOGOOOOOOOOOOOOOOOOOOAAOGOOOOOOOOOOOOOOOOOOOOOGOOOOOOOOOOOOOOOOOOOOOGOOOOOOOOOOOOOOOOOOOOOGOOOOOOOOOOOOOOOXXXXXXGOOOOOOOOOOOOOOOOOOOOOGOOOOOOOOOOOOOAAXXXXXX,0,0,0
7833,265,8,257,149,186,0,0,445,364,81,GOOOOOOOOOOOOOOOOOOOOOGOOOOOOOOOOOOOOOOOOOOOGOOOOOOOOOOOOOAOAXXXXXGOOOOOOOOOOOOAOOOAOOXXGOOOOOOOOOOOOOOOOOOOXXGOOOOOOOOOOOOOOOOOOOOOGOOOOOOOOOOOOOOOOOOAAOGOOOOOOOOOOOOOOOOOOOOOGOOOOOOOOOOOOOOOOOOOOOGOOOOOOOOOOOOOOOOOOOOOGOOOOOOOOOOOOOOOXXXXXXGOOOOOOOOOOOOOOOOOOOOOGOOOOOOOOOOOOOAAXXXXXX,0,0,0
7854,265,8,257,151,184,0,0,443,361,82,GOOOOOOOOOOOOOOOOOOOOOGOOOOOOOOOOOOOOOOOOOOOGOOOOOOOOOOOOOAOAXXXXXGOOOOOOOOOOOOAOOOAOOXXGOOOOOOOOOOOOOOOOOOOXXGOOOOOOOOOOOOOOOOOOOOOGOOOOOOOOOOOOOOOOOOAAOGOOOOOOOOOOOOOOOOOOOOOGOOOOOOOOOOOOOOOOOOOOOGOOOOOOOOOOOOOOOOOOOOOGOOOOOOOOOOOOOOOXXXXXXGOOOOOOOOOOOOOOOOOOOOOGOOOOOOOOOOOOOAAXXXXXX,0,0,0

7875,265,8,257,154,181,0,0,440,360,80,GOOOOOOOOOOOOOOOOOOOOOGOOOOOOOOOOOOOOOOOOOOOGOOOOOOOOOOOOOAOAXXXXXGOOOOOOOOOOOOAOOOAOOXXGOOOOOOOOOOOOOOOOOOOXXGOOOOOOOOOOOOOOOOOOOOOGOOOOOOOOOOOOOOOOOOAAOGOOOOOOOOOOOOOOOOOOOOOGOOOOOOOOOOOOOOOOOOOOOGOOOOOOOOOOOOOOOOOOOOOGOOOOOOOOOOOOOOOXXXXXXGOOOOOOOOOOOOOOOOOOOOOGOOOOOOOOOOOOOAAXXXXXX,0,0,0
7896,266,9,257,154,180,0,0,439,365,74,GOOOOOOOOOOOOOOOOOOOOOGOOOOOOOOOOOOOOOOOOOOOGOOOOOOOOOOOOOAOAXXXXXGOOOOOOOOOOOOAOOOAOOXXGOOOOOOOOOOOOOOOOOOOAXGOOOOOOOOOOOOOOOOOOOOOGOOOOOOOOOOOOOOOOOOAAOGOOOOOOOOOOOOOOOOOOOOOGOOOOOOOOOOOOOOOOOOOOOGOOOOOOOOOOOOOOOOOOOOOGOOOOOOOOOOOOOOOXXXXXXGOOOOOOOOOOOOOOOOOOOOOGOOOOOOOOOOOOOAAXXXXXX,0,0,0
7917,266,9,257,152,182,0,0,440,364,76,GOOOOOOOOOOOOOOOOOOOOOGOOOOOOOOOOOOOOOOOOOOOGOOOOOOOOOOOOOAOAXXXXXGOOOOOOOOOOOOAOOOAOOXXGOOOOOOOOOOOOOOOOOOOAXGOOOOOOOOOOOOOOOOOOOOOGOOOOOOOOOOOOOOOOOOAAOGOOOOOOOOOOOOOOOOOOOOOGOOOOOOOOOOOOOOOOOOOOOGOOOOOOOOOOOOOOOOOOOOOGOOOOOOOOOOOOOOOXXXXXXGOOOOOOOOOOOOOOOOOOOOOGOOOOOOOOOOOOOAAXXXXXX,0,0,0
7938,266,9,257,155,179,0,0,438,362,76,GOOOOOOOOOOOOOOOOOOOOOGOOOOOOOOOOOOOOOOOOOOOGOOOOOOOOOOOOOAOAXXXXXGOOOOOOOOOOOOAOOOAOOXXGOOOOOOOOOOOOOOOOOOOAXGOOOOOOOOOOOOOOOOOOOOOGOOOOOOOOOOOOOOOOOOAAOGOOOOOOOOOOOOOOOOOOOOOGOOOOOOOOOOOOOOOOOOOOOGOOOOOOOOOOOOOOOOOOOOOGOOOOOOOOOOOOOOOXXXXXXGOOOOOOOOOOOOOOOOOOOOOGOOOOOOOOOOOOOAAXXXXXX,0,0,0
7959,268,11,257,155,177,0,0,435,361,74,GOOOOOOOOOOOOOOOOOOOOOGOOOOOOOOOOOOOOOOOOOOOGOOOOOOOOOOOOOAOAXXXXXGOOOOOOOOOOOOAOOOAOOXXGOOOOOOOOOOOOOOOOOOOAAGOOOOOOOOOOOOOOOOOOOOOGOOOOOOOOOOOOOOOOOOAAOGOOOOOOOOOOOOOOOOOOOOOGOOOOOOOOOOOOOOOOOOOOOGOOOOOOOOOOOOOOOOOOOOOGOOOOOOOOOOOOOOOAXXXXXGOOOOOOOOOOOOOOOOOOOOOGOOOOOOOOOOOOOAAXXXXXX,0,0,0

7980,268,9,259,153,179,0,0,440,362,78,GOOOOOOOOOOOOOOOOOOOOOGOOOOOOOOOOOOOOOOOOOOOGOOOOOOOOOOOOOAOAXXXXXGOOOOOOOOOOOOAOOOOOOXXGOOOOOOOOOOOOOOOOOOOAAGOOOOOOOOOOOOOOOOOOOOOGOOOOOOOOOOOOOOOOOOAAOGOOOOOOOOOOOOOOOOOOOOOGOOOOOOOOOOOOOOOOOOOOOGOOOOOOOOOOOOOOOOOOOOOGOOOOOOOOOOOOOOOAXXXXXGOOOOOOOOOOOOOOOOOOOOOGOOOOOOOOOOOOOOAXXXXXX,0,0,0
8001,268,9,259,155,177,0,0,437,356,81,GOOOOOOOOOOOOOOOOOOOOOGOOOOOOOOOOOOOOOOOOOOOGOOOOOOOOOOOOOAOAXXXXXGOOOOOOOOOOOOAOOOOOOXXGOOOOOOOOOOOOOOOOOOOAAGOOOOOOOOOOOOOOOOOOOOOGOOOOOOOOOOOOOOOOOOAAOGOOOOOOOOOOOOOOOOOOOOOGOOOOOOOOOOOOOOOOOOOOOGOOOOOOOOOOOOOOOOOOOOOGOOOOOOOOOOOOOOOAXXXXXGOOOOOOOOOOOOOOOOOOOOOGOOOOOOOOOOOOOOAXXXXXX,0,0,0
8022,268,7,261,154,178,0,0,441,356,85,GOOOOOOOOOOOOOOOOOOOOOGOOOOOOOOOOOOOOOOOOOOOGOOOOOOOOOOOOOAOAXXXXXGOOOOOOOOOOOOOOOOOOOXXGOOOOOOOOOOOOOOOOOOOAAGOOOOOOOOOOOOOOOOOOOOOGOOOOOOOOOOOOOOOOOOAOOGOOOOOOOOOOOOOOOOOOOOOGOOOOOOOOOOOOOOOOOOOOOGOOOOOOOOOOOOOOOOOOOOOGOOOOOOOOOOOOOOOAXXXXXGOOOOOOOOOOOOOOOOOOOOOGOOOOOOOOOOOOOOAXXXXXX,0,0,0
8043,268,7,261,155,177,0,0,440,359,81,GOOOOOOOOOOOOOOOOOOOOOGOOOOOOOOOOOOOOOOOOOOOGOOOOOOOOOOOOOAOAXXXXXGOOOOOOOOOOOOOOOOOOOXXGOOOOOOOOOOOOOOOOOOOAAGOOOOOOOOOOOOOOOOOOOOOGOOOOOOOOOOOOOOOOOOAOOGOOOOOOOOOOOOOOOOOOOOOGOOOOOOOOOOOOOOOOOOOOOGOOOOOOOOOOOOOOOOOOOOOGOOOOOOOOOOOOOOOAXXXXXGOOOOOOOOOOOOOOOOOOOOOGOOOOOOOOOOOOOOAXXXXXX,0,0,0
8064,268,7,261,155,177,0,0,441,362,79,GOOOOOOOOOOOOOOOOOOOOOGOOOOOOOOOOOOOOOOOOOOOGOOOOOOOOOOOOOAOAXXXXXGOOOOOOOOOOOOOOOOOOOXXGOOOOOOOOOOOOOOOOOOOAAGOOOOOOOOOOOOOOOOOOOOOGOOOOOOOOOOOOOOOOOOAOOGOOOOOOOOOOOOOOOOOOOOOGOOOOOOOOOOOOOOOOOOOOOGOOOOOOOOOOOOOOOOOOOOOGOOOOOOOOOOOOOOOAXXXXXGOOOOOOOOOOOOOOOOOOOOOGOOOOOOOOOOOOOOAXXXXXX,0,0,0

8085,269,7,262,154,177,0,0,442,361,81,GOOOOOOOOOOOOOOOOOOOOOGOOOOOOOOOOOOOOOOOOOOOGOOOOOOOOOOOOOAOAXXXXXGOOOOOOOOOOOOOOOOOOOAXGOOOOOOOOOOOOOOOOOOOAAGOOOOOOOOOOOOOOOOOOOOOGOOOOOOOOOOOOOOOOOOOOOGOOOOOOOOOOOOOOOOOOOOOGOOOOOOOOOOOOOOOOOOOOOGOOOOOOOOOOOOOOOOOOOOOGOOOOOOOOOOOOOOOAXXXXXGOOOOOOOOOOOOOOOOOOOOOGOOOOOOOOOOOOOOAXXXXXX,0,0,0
8106,270,8,262,156,174,0,0,439,359,80,GOOOOOOOOOOOOOOOOOOOOOGOOOOOOOOOOOOOOOOOOOOOGOOOOOOOOOOOOOAOAXXXXXGOOOOOOOOOOOOOOOOOOOAXGOOOOOOOOOOOOOOOOOOOAAGOOOOOOOOOOOOOOOOOOOOOGOOOOOOOOOOOOOOOOOOOOOGOOOOOOOOOOOOOOOOOOOOOGOOOOOOOOOOOOOOOOOOOOOGOOOOOOOOOOOOOOOOOOOOOGOOOOOOOOOOOOOOOAAXXXXGOOOOOOOOOOOOOOOOOOOOOGOOOOOOOOOOOOOOAXXXXXX,0,0,0
8127,270,8,262,152,178,0,0,443,362,81,GOOOOOOOOOOOOOOOOOOOOOGOOOOOOOOOOOOOOOOOOOOOGOOOOOOOOOOOOOAOAXXXXXGOOOOOOOOOOOOOOOOOOOAXGOOOOOOOOOOOOOOOOOOOAAGOOOOOOOOOOOOOOOOOOOOOGOOOOOOOOOOOOOOOOOOOOOGOOOOOOOOOOOOOOOOOOOOOGOOOOOOOOOOOOOOOOOOOOOGOOOOOOOOOOOOOOOOOOOOOGOOOOOOOOOOOOOOOAAXXXXGOOOOOOOOOOOOOOOOOOOOOGOOOOOOOOOOOOOOAXXXXXX,0,0,0
8148,272,10,262,146,182,0,0,447,364,83,GOOOOOOOOOOOOOOOOOOOOOGOOOOOOOOOOOOOOOOOOOOOGOOOOOOOOOOOOOAOAXXXXXGOOOOOOOOOOOOOOOOOOOAAGOOOOOOOOOOOOOOOOOOOAAGOOOOOOOOOOOOOOOOOOOOOGOOOOOOOOOOOOOOOOOOOOOGOOOOOOOOOOOOOOOOOOOOOGOOOOOOOOOOOOOOOOOOOOOGOOOOOOOOOOOOOOOOOOOOOGOOOOOOOOOOOOOOOAAXXXXGOOOOOOOOOOOOOOOOOOOOOGOOOOOOOOOOOOOOAAXXXXX,0,0,0
8169,272,9,263,144,184,0,0,450,364,86,GOOOOOOOOOOOOOOOOOOOOOGOOOOOOOOOOOOOOOOOOOOOGOOOOOOOOOOOOOAOAXXXXXGOOOOOOOOOOOOOOOOOOOAAGOOOOOOOOOOOOOOOOOOOAAGOOOOOOOOOOOOOOOOOOOOOGOOOOOOOOOOOOOOOOOOOOOGOOOOOOOOOOOOOOOOOOOOOGOOOOOOOOOOOOOOOOOOOOOGOOOOOOOOOOOOOOOOOOOOOGOOOOOOOOOOOOOOOAAXXXXGOOOOOOOOOOOOOOOOOOOOOGOOOOOOOOOOOOOOOAXXXXX,0,0,0

8190,272,9,263,142,186,0,0,452,364,88,GOOOOOOOOOOOOOOOOOOOOOGOOOOOOOOOOOOOOOOOOOOOGOOOOOOOOOOOOOAOAXXXXXGOOOOOOOOOOOOOOOOOOOAAGOOOOOOOOOOOOOOOOOOOAAGOOOOOOOOOOOOOOOOOOOOOGOOOOOOOOOOOOOOOOOOOOOGOOOOOOOOOOOOOOOOOOOOOGOOOOOOOOOOOOOOOOOOOOOGOOOOOOOOOOOOOOOOOOOOOGOOOOOOOOOOOOOOOAAXXXXGOOOOOOOOOOOOOOOOOOOOOGOOOOOOOOOOOOOOOAXXXXX,0,0,0
8211,272,9,263,138,190,0,0,455,371,84,GOOOOOOOOOOOOOOOOOOOOOGOOOOOOOOOOOOOOOOOOOOOGOOOOOOOOOOOOOAOAXXXXXGOOOOOOOOOOOOOOOOOOOAAGOOOOOOOOOOOOOOOOOOOAAGOOOOOOOOOOOOOOOOOOOOOGOOOOOOOOOOOOOOOOOOOOOGOOOOOOOOOOOOOOOOOOOOOGOOOOOOOOOOOOOOOOOOOOOGOOOOOOOOOOOOOOOOOOOOOGOOOOOOOOOOOOOOOAAXXXXGOOOOOOOOOOOOOOOOOOOOOGOOOOOOOOOOOOOOOAXXXXX,0,0,0
8232,272,9,263,140,188,0,0,454,371,83,GOOOOOOOOOOOOOOOOOOOOOGOOOOOOOOOOOOOOOOOOOOOGOOOOOOOOOOOOOAOAXXXXXGOOOOOOOOOOOOOOOOOOOAAGOOOOOOOOOOOOOOOOOOOAAGOOOOOOOOOOOOOOOOOOOOOGOOOOOOOOOOOOOOOOOOOOOGOOOOOOOOOOOOOOOOOOOOOGOOOOOOOOOOOOOOOOOOOOOGOOOOOOOOOOOOOOOOOOOOOGOOOOOOOOOOOOOOOAAXXXXGOOOOOOOOOOOOOOOOOOOOOGOOOOOOOOOOOOOOOAXXXXX,0,0,0
8253,272,9,263,137,191,0,0,456,372,84,GOOOOOOOOOOOOOOOOOOOOOGOOOOOOOOOOOOOOOOOOOOOGOOOOOOOOOOOOOAOAXXXXXGOOOOOOOOOOOOOOOOOOOAAGOOOOOOOOOOOOOOOOOOOAAGOOOOOOOOOOOOOOOOOOOOOGOOOOOOOOOOOOOOOOOOOOOGOOOOOOOOOOOOOOOOOOOOOGOOOOOOOOOOOOOOOOOOOOOGOOOOOOOOOOOOOOOOOOOOOGOOOOOOOOOOOOOOOAAXXXXGOOOOOOOOOOOOOOOOOOOOOGOOOOOOOOOOOOOOOAXXXXX,0,0,0
8274,273,9,264,136,191,0,0,458,370,88,GOOOOOOOOOOOOOOOOOOOOOGOOOOOOOOOOOOOOOOOOOOOGOOOOOOOOOOOOOAOAAXXXXGOOOOOOOOOOOOOOOOOOOAOGOOOOOOOOOOOOOOOOOOOAAGOOOOOOOOOOOOOOOOOOOOOGOOOOOOOOOOOOOOOOOOOOOGOOOOOOOOOOOOOOOOOOOOOGOOOOOOOOOOOOOOOOOOOOOGOOOOOOOOOOOOOOOOOOOOOGOOOOOOOOOOOOOOOAAXXXXGOOOOOOOOOOOOOOOOOOOOOGOOOOOOOOOOOOOOOAXXXXX,0,0,0

8295,273,9,264,140,187,0,0,454,368,86,GOOOOOOOOOOOOOOOOOOOOOGOOOOOOOOOOOOOOOOOOOOOGOOOOOOOOOOOOOAOAAXXXXGOOOOOOOOOOOOOOOOOOOAOGOOOOOOOOOOOOOOOOOOOAAGOOOOOOOOOOOOOOOOOOOOOGOOOOOOOOOOOOOOOOOOOOOGOOOOOOOOOOOOOOOOOOOOOGOOOOOOOOOOOOOOOOOOOOOGOOOOOOOOOOOOOOOOOOOOOGOOOOOOOOOOOOOOOAAXXXXGOOOOOOOOOOOOOOOOOOOOOGOOOOOOOOOOOOOOOAXXXXX,0,0,0
8316,273,9,264,143,184,0,0,450,370,80,GOOOOOOOOOOOOOOOOOOOOOGOOOOOOOOOOOOOOOOOOOOOGOOOOOOOOOOOOOAOAAXXXXGOOOOOOOOOOOOOOOOOOOAOGOOOOOOOOOOOOOOOOOOOAAGOOOOOOOOOOOOOOOOOOOOOGOOOOOOOOOOOOOOOOOOOOOGOOOOOOOOOOOOOOOOOOOOOGOOOOOOOOOOOOOOOOOOOOOGOOOOOOOOOOOOOOOOOOOOOGOOOOOOOOOOOOOOOAAXXXXGOOOOOOOOOOOOOOOOOOOOOGOOOOOOOOOOOOOOOAXXXXX,0,0,0
8337,273,8,265,144,183,0,0,449,370,79,GOOOOOOOOOOOOOOOOOOOOOGOOOOOOOOOOOOOOOOOOOOOGOOOOOOOOOOOOOAOAAXXXXGOOOOOOOOOOOOOOOOOOOAOGOOOOOOOOOOOOOOOOOOOAAGOOOOOOOOOOOOOOOOOOOOOGOOOOOOOOOOOOOOOOOOOOOGOOOOOOOOOOOOOOOOOOOOOGOOOOOOOOOOOOOOOOOOOOOGOOOOOOOOOOOOOOOOOOOOOGOOOOOOOOOOOOOOOOAXXXXGOOOOOOOOOOOOOOOOOOOOOGOOOOOOOOOOOOOOOAXXXXX,0,0,0
8358,273,8,265,145,182,0,0,449,369,80,GOOOOOOOOOOOOOOOOOOOOOGOOOOOOOOOOOOOOOOOOOOOGOOOOOOOOOOOOOAOAAXXXXGOOOOOOOOOOOOOOOOOOOAOGOOOOOOOOOOOOOOOOOOOAAGOOOOOOOOOOOOOOOOOOOOOGOOOOOOOOOOOOOOOOOOOOOGOOOOOOOOOOOOOOOOOOOOOGOOOOOOOOOOOOOOOOOOOOOGOOOOOOOOOOOOOOOOOOOOOGOOOOOOOOOOOOOOOOAXXXXGOOOOOOOOOOOOOOOOOOOOOGOOOOOOOOOOOOOOOAXXXXX,0,0,0
8379,274,9,265,144,182,0,0,449,370,79,GOOOOOOOOOOOOOOOOOOOOOGOOOOOOOOOOOOOOOOOOOOOGOOOOOOOOOOOOOAOAAAXXXGOOOOOOOOOOOOOOOOOOOAOGOOOOOOOOOOOOOOOOOOOAAGOOOOOOOOOOOOOOOOOOOOOGOOOOOOOOOOOOOOOOOOOOOGOOOOOOOOOOOOOOOOOOOOOGOOOOOOOOOOOOOOOOOOOOOGOOOOOOOOOOOOOOOOOOOOOGOOOOOOOOOOOOOOOOAXXXXGOOOOOOOOOOOOOOOOOOOOOGOOOOOOOOOOOOOOOAXXXXX,0,0,0

8400,274,9,265,140,186,0,0,453,372,81,GOOOOOOOOOOOOOOOOOOOOOGOOOOOOOOOOOOOOOOOOOOOGOOOOOOOOOOOOOAOAAAXXXGOOOOOOOOOOOOOOOOOOOAOGOOOOOOOOOOOOOOOOOOOAAGOOOOOOOOOOOOOOOOOOOOOGOOOOOOOOOOOOOOOOOOOOOGOOOOOOOOOOOOOOOOOOOOOGOOOOOOOOOOOOOOOOOOOOOGOOOOOOOOOOOOOOOOOOOOOGOOOOOOOOOOOOOOOOAXXXXGOOOOOOOOOOOOOOOOOOOOOGOOOOOOOOOOOOOOOAXXXXX,0,0,0
8421,275,9,266,142,183,0,0,450,373,77,GOOOOOOOOOOOOOOOOOOOOOGOOOOOOOOOOOOOOOOOOOOOGOOOOOOOOOOOOOOOAAAAXXGOOOOOOOOOOOOOOOOOOOAOGOOOOOOOOOOOOOOOOOOOAAGOOOOOOOOOOOOOOOOOOOOOGOOOOOOOOOOOOOOOOOOOOOGOOOOOOOOOOOOOOOOOOOOOGOOOOOOOOOOOOOOOOOOOOOGOOOOOOOOOOOOOOOOOOOOOGOOOOOOOOOOOOOOOOAXXXXGOOOOOOOOOOOOOOOOOOOOOGOOOOOOOOOOOOOOOAXXXXX,0,0,0
8442,275,8,267,145,180,0,0,449,373,76,GOOOOOOOOOOOOOOOOOOOOOGOOOOOOOOOOOOOOOOOOOOOGOOOOOOOOOOOOOOOAAAOXXGOOOOOOOOOOOOOOOOOOOAOGOOOOOOOOOOOOOOOOOOOAAGOOOOOOOOOOOOOOOOOOOOOGOOOOOOOOOOOOOOOOOOOOOGOOOOOOOOOOOOOOOOOOOOOGOOOOOOOOOOOOOOOOOOOOOGOOOOOOOOOOOOOOOOOOOOOGOOOOOOOOOOOOOOOOAXXXXGOOOOOOOOOOOOOOOOOOOOOGOOOOOOOOOOOOOOOAXXXXX,0,0,0
8463,275,8,267,145,180,0,0,449,374,75,GOOOOOOOOOOOOOOOOOOOOOGOOOOOOOOOOOOOOOOOOOOOGOOOOOOOOOOOOOOOAAAOXXGOOOOOOOOOOOOOOOOOOOAOGOOOOOOOOOOOOOOOOOOOAAGOOOOOOOOOOOOOOOOOOOOOGOOOOOOOOOOOOOOOOOOOOOGOOOOOOOOOOOOOOOOOOOOOGOOOOOOOOOOOOOOOOOOOOOGOOOOOOOOOOOOOOOOOOOOOGOOOOOOOOOOOOOOOOAXXXXGOOOOOOOOOOOOOOOOOOOOOGOOOOOOOOOOOOOOOAXXXXX,0,0,0
8484,275,8,267,143,182,0,0,450,371,79,GOOOOOOOOOOOOOOOOOOOOOGOOOOOOOOOOOOOOOOOOOOOGOOOOOOOOOOOOOOOAAAOXXGOOOOOOOOOOOOOOOOOOOAOGOOOOOOOOOOOOOOOOOOOAAGOOOOOOOOOOOOOOOOOOOOOGOOOOOOOOOOOOOOOOOOOOOGOOOOOOOOOOOOOOOOOOOOOGOOOOOOOOOOOOOOOOOOOOOGOOOOOOOOOOOOOOOOOOOOOGOOOOOOOOOOOOOOOOAXXXXGOOOOOOOOOOOOOOOOOOOOOGOOOOOOOOOOOOOOOAXXXXX,0,0,0

8505,275,8,267,142,183,0,0,452,375,77,GOOOOOOOOOOOOOOOOOOOOOGOOOOOOOOOOOOOOOOOOOOOGOOOOOOOOOOOOOOOAAAOXXGOOOOOOOOOOOOOOOOOOOAOGOOOOOOOOOOOOOOOOOOOAAGOOOOOOOOOOOOOOOOOOOOOGOOOOOOOOOOOOOOOOOOOOOGOOOOOOOOOOOOOOOOOOOOOGOOOOOOOOOOOOOOOOOOOOOGOOOOOOOOOOOOOOOOOOOOOGOOOOOOOOOOOOOOOOAXXXXGOOOOOOOOOOOOOOOOOOOOOGOOOOOOOOOOOOOOOAXXXXX,0,0,0
8526,275,8,267,141,184,0,0,453,381,72,GOOOOOOOOOOOOOOOOOOOOOGOOOOOOOOOOOOOOOOOOOOOGOOOOOOOOOOOOOOOAAAOXXGOOOOOOOOOOOOOOOOOOOAOGOOOOOOOOOOOOOOOOOOOAAGOOOOOOOOOOOOOOOOOOOOOGOOOOOOOOOOOOOOOOOOOOOGOOOOOOOOOOOOOOOOOOOOOGOOOOOOOOOOOOOOOOOOOOOGOOOOOOOOOOOOOOOOOOOOOGOOOOOOOOOOOOOOOOAXXXXGOOOOOOOOOOOOOOOOOOOOOGOOOOOOOOOOOOOOOAXXXXX,0,0,0
8547,275,8,267,141,184,0,0,453,381,72,GOOOOOOOOOOOOOOOOOOOOOGOOOOOOOOOOOOOOOOOOOOOGOOOOOOOOOOOOOOOAAAOXXGOOOOOOOOOOOOOOOOOOOAOGOOOOOOOOOOOOOOOOOOOAAGOOOOOOOOOOOOOOOOOOOOOGOOOOOOOOOOOOOOOOOOOOOGOOOOOOOOOOOOOOOOOOOOOGOOOOOOOOOOOOOOOOOOOOOGOOOOOOOOOOOOOOOOOOOOOGOOOOOOOOOOOOOOOOAXXXXGOOOOOOOOOOOOOOOOOOOOOGOOOOOOOOOOOOOOOAXXXXX,0,0,0
8568,275,8,267,142,183,0,0,451,380,71,GOOOOOOOOOOOOOOOOOOOOOGOOOOOOOOOOOOOOOOOOOOOGOOOOOOOOOOOOOOOAAAOXXGOOOOOOOOOOOOOOOOOOOAOGOOOOOOOOOOOOOOOOOOOAAGOOOOOOOOOOOOOOOOOOOOOGOOOOOOOOOOOOOOOOOOOOOGOOOOOOOOOOOOOOOOOOOOOGOOOOOOOOOOOOOOOOOOOOOGOOOOOOOOOOOOOOOOOOOOOGOOOOOOOOOOOOOOOOAXXXXGOOOOOOOOOOOOOOOOOOOOOGOOOOOOOOOOOOOOOAXXXXX,0,0,0
8589,275,8,267,143,182,0,0,450,379,71,GOOOOOOOOOOOOOOOOOOOOOGOOOOOOOOOOOOOOOOOOOOOGOOOOOOOOOOOOOOOAAAOXXGOOOOOOOOOOOOOOOOOOOAOGOOOOOOOOOOOOOOOOOOOAAGOOOOOOOOOOOOOOOOOOOOOGOOOOOOOOOOOOOOOOOOOOOGOOOOOOOOOOOOOOOOOOOOOGOOOOOOOOOOOOOOOOOOOOOGOOOOOOOOOOOOOOOOOOOOOGOOOOOOOOOOOOOOOOAXXXXGOOOOOOOOOOOOOOOOOOOOOGOOOOOOOOOOOOOOOAXXXXX,0,0,0

8610,275,8,267,144,181,0,0,449,382,67,GOOOOOOOOOOOOOOOOOOOOOGOOOOOOOOOOOOOOOOOOOOOGOOOOOOOOOOOOOOOAAAOXXGOOOOOOOOOOOOOOOOOOOAOGOOOOOOOOOOOOOOOOOOOAAGOOOOOOOOOOOOOOOOOOOOOGOOOOOOOOOOOOOOOOOOOOOGOOOOOOOOOOOOOOOOOOOOOGOOOOOOOOOOOOOOOOOOOOOGOOOOOOOOOOOOOOOOOOOOOGOOOOOOOOOOOOOOOOAXXXXGOOOOOOOOOOOOOOOOOOOOOGOOOOOOOOOOOOOOOAXXXXX,0,0,0
8631,275,8,267,142,183,0,0,451,385,66,GOOOOOOOOOOOOOOOOOOOOOGOOOOOOOOOOOOOOOOOOOOOGOOOOOOOOOOOOOOOAAAOXXGOOOOOOOOOOOOOOOOOOOAOGOOOOOOOOOOOOOOOOOOOAAGOOOOOOOOOOOOOOOOOOOOOGOOOOOOOOOOOOOOOOOOOOOGOOOOOOOOOOOOOOOOOOOOOGOOOOOOOOOOOOOOOOOOOOOGOOOOOOOOOOOOOOOOOOOOOGOOOOOOOOOOOOOOOOAXXXXGOOOOOOOOOOOOOOOOOOOOOGOOOOOOOOOOOOOOOAXXXXX,0,0,0
8652,276,9,267,142,182,0,0,450,390,60,GOOOOOOOOOOOOOOOOOOOOOGOOOOOOOOOOOOOOOOOOOOOGOOOOOOOOOOOOOOOAAAOXXGOOOOOOOOOOOOOOOOOOOAOGOOOOOOOOOOOOOOOOOOOAAGOOOOOOOOOOOOOOOOOOOOOGOOOOOOOOOOOOOOOOOOOOOGOOOOOOOOOOOOOOOOOOOOOGOOOOOOOOOOOOOOOOOOOOOGOOOOOOOOOOOOOOOOOOOOOGOOOOOOOOOOOOOOOOAXXXXGOOOOOOOOOOOOOOOOOOOOOGOOOOOOOOOOOOOOOAAXXXX,0,0,0
8673,276,8,268,142,182,0,0,450,390,60,GOOOOOOOOOOOOOOOOOOOOOGOOOOOOOOOOOOOOOOOOOOOGOOOOOOOOOOOOOOOAAAOXXGOOOOOOOOOOOOOOOOOOOAOGOOOOOOOOOOOOOOOOOOOAAGOOOOOOOOOOOOOOOOOOOOOGOOOOOOOOOOOOOOOOOOOOOGOOOOOOOOOOOOOOOOOOOOOGOOOOOOOOOOOOOOOOOOOOOGOOOOOOOOOOOOOOOOOOOOOGOOOOOOOOOOOOOOOOAXXXXGOOOOOOOOOOOOOOOOOOOOOGOOOOOOOOOOOOOOOOAXXXX,0,0,0
8694,276,7,269,143,181,0,0,451,389,62,GOOOOOOOOOOOOOOOOOOOOOGOOOOOOOOOOOOOOOOOOOOOGOOOOOOOOOOOOOOOAAAOXXGOOOOOOOOOOOOOOOOOOOAOGOOOOOOOOOOOOOOOOOOOAAGOOOOOOOOOOOOOOOOOOOOOGOOOOOOOOOOOOOOOOOOOOOGOOOOOOOOOOOOOOOOOOOOOGOOOOOOOOOOOOOOOOOOOOOGOOOOOOOOOOOOOOOOOOOOOGOOOOOOOOOOOOOOOOAXXXXGOOOOOOOOOOOOOOOOOOOOOGOOOOOOOOOOOOOOOOOXXXX,0,0,0

8715,276,7,269,145,179,0,0,449,390,59,GOOOOOOOOOOOOOOOOOOOOOGOOOOOOOOOOOOOOOOOOOOOGOOOOOOOOOOOOOOOAAAOXXGOOOOOOOOOOOOOOOOOOOAOGOOOOOOOOOOOOOOOOOOOAAGOOOOOOOOOOOOOOOOOOOOOGOOOOOOOOOOOOOOOOOOOOOGOOOOOOOOOOOOOOOOOOOOOGOOOOOOOOOOOOOOOOOOOOOGOOOOOOOOOOOOOOOOOOOOOGOOOOOOOOOOOOOOOOAXXXXGOOOOOOOOOOOOOOOOOOOOOGOOOOOOOOOOOOOOOOOXXXX,0,0,0
8736,276,7,269,145,179,0,0,449,390,59,GOOOOOOOOOOOOOOOOOOOOOGOOOOOOOOOOOOOOOOOOOOOGOOOOOOOOOOOOOOOAAAOXXGOOOOOOOOOOOOOOOOOOOAOGOOOOOOOOOOOOOOOOOOOAAGOOOOOOOOOOOOOOOOOOOOOGOOOOOOOOOOOOOOOOOOOOOGOOOOOOOOOOOOOOOOOOOOOGOOOOOOOOOOOOOOOOOOOOOGOOOOOOOOOOOOOOOOOOOOOGOOOOOOOOOOOOOOOOAXXXXGOOOOOOOOOOOOOOOOOOOOOGOOOOOOOOOOOOOOOOOXXXX,0,0,0
8757,276,6,270,144,180,0,0,451,390,61,GOOOOOOOOOOOOOOOOOOOOOGOOOOOOOOOOOOOOOOOOOOOGOOOOOOOOOOOOOOOAAAOXXGOOOOOOOOOOOOOOOOOOOOOGOOOOOOOOOOOOOOOOOOOAAGOOOOOOOOOOOOOOOOOOOOOGOOOOOOOOOOOOOOOOOOOOOGOOOOOOOOOOOOOOOOOOOOOGOOOOOOOOOOOOOOOOOOOOOGOOOOOOOOOOOOOOOOOOOOOGOOOOOOOOOOOOOOOOAXXXXGOOOOOOOOOOOOOOOOOOOOOGOOOOOOOOOOOOOOOOOXXXX,0,0,0
8778,276,6,270,145,179,0,0,450,391,59,GOOOOOOOOOOOOOOOOOOOOOGOOOOOOOOOOOOOOOOOOOOOGOOOOOOOOOOOOOOOAAAOXXGOOOOOOOOOOOOOOOOOOOOOGOOOOOOOOOOOOOOOOOOOAAGOOOOOOOOOOOOOOOOOOOOOGOOOOOOOOOOOOOOOOOOOOOGOOOOOOOOOOOOOOOOOOOOOGOOOOOOOOOOOOOOOOOOOOOGOOOOOOOOOOOOOOOOOOOOOGOOOOOOOOOOOOOOOOAXXXXGOOOOOOOOOOOOOOOOOOOOOGOOOOOOOOOOOOOOOOOXXXX,0,0,0
8799,276,5,271,149,175,0,0,446,387,59,GOOOOOOOOOOOOOOOOOOOOOGOOOOOOOOOOOOOOOOOOOOOGOOOOOOOOOOOOOOOOAAOXXGOOOOOOOOOOOOOOOOOOOOOGOOOOOOOOOOOOOOOOOOOAAGOOOOOOOOOOOOOOOOOOOOOGOOOOOOOOOOOOOOOOOOOOOGOOOOOOOOOOOOOOOOOOOOOGOOOOOOOOOOOOOOOOOOOOOGOOOOOOOOOOOOOOOOOOOOOGOOOOOOOOOOOOOOOOAXXXXGOOOOOOOOOOOOOOOOOOOOOGOOOOOOOOOOOOOOOOOXXXX,0,0,0

8820,276,5,271,148,176,0,0,447,387,60,GOOOOOOOOOOOOOOOOOOOOOGOOOOOOOOOOOOOOOOOOOOOGOOOOOOOOOOOOOOOOAAOXXGOOOOOOOOOOOOOOOOOOOOOGOOOOOOOOOOOOOOOOOOOAAGOOOOOOOOOOOOOOOOOOOOOGOOOOOOOOOOOOOOOOOOOOOGOOOOOOOOOOOOOOOOOOOOOGOOOOOOOOOOOOOOOOOOOOOGOOOOOOOOOOOOOOOOOOOOOGOOOOOOOOOOOOOOOOAXXXXGOOOOOOOOOOOOOOOOOOOOOGOOOOOOOOOOOOOOOOOXXXX,0,0,0
8841,276,4,272,154,170,0,0,442,384,58,GOOOOOOOOOOOOOOOOOOOOOGOOOOOOOOOOOOOOOOOOOOOGOOOOOOOOOOOOOOOOAOOXXGOOOOOOOOOOOOOOOOOOOOOGOOOOOOOOOOOOOOOOOOOAAGOOOOOOOOOOOOOOOOOOOOOGOOOOOOOOOOOOOOOOOOOOOGOOOOOOOOOOOOOOOOOOOOOGOOOOOOOOOOOOOOOOOOOOOGOOOOOOOOOOOOOOOOOOOOOGOOOOOOOOOOOOOOOOAXXXXGOOOOOOOOOOOOOOOOOOOOOGOOOOOOOOOOOOOOOOOXXXX,0,0,0
8862,278,6,272,149,173,0,0,445,385,60,GOOOOOOOOOOOOOOOOOOOOOGOOOOOOOOOOOOOOOOOOOOOGOOOOOOOOOOOOOOOOAOOAAGOOOOOOOOOOOOOOOOOOOOOGOOOOOOOOOOOOOOOOOOOAAGOOOOOOOOOOOOOOOOOOOOOGOOOOOOOOOOOOOOOOOOOOOGOOOOOOOOOOOOOOOOOOOOOGOOOOOOOOOOOOOOOOOOOOOGOOOOOOOOOOOOOOOOOOOOOGOOOOOOOOOOOOOOOOAXXXXGOOOOOOOOOOOOOOOOOOOOOGOOOOOOOOOOOOOOOOOXXXX,0,0,0
8883,278,6,272,145,177,0,0,449,383,66,GOOOOOOOOOOOOOOOOOOOOOGOOOOOOOOOOOOOOOOOOOOOGOOOOOOOOOOOOOOOOAOOAAGOOOOOOOOOOOOOOOOOOOOOGOOOOOOOOOOOOOOOOOOOAAGOOOOOOOOOOOOOOOOOOOOOGOOOOOOOOOOOOOOOOOOOOOGOOOOOOOOOOOOOOOOOOOOOGOOOOOOOOOOOOOOOOOOOOOGOOOOOOOOOOOOOOOOOOOOOGOOOOOOOOOOOOOOOOAXXXXGOOOOOOOOOOOOOOOOOOOOOGOOOOOOOOOOOOOOOOOXXXX,0,0,0
8904,278,4,274,143,179,0,0,451,383,68,GOOOOOOOOOOOOOOOOOOOOOGOOOOOOOOOOOOOOOOOOOOOGOOOOOOOOOOOOOOOOOOOAAGOOOOOOOOOOOOOOOOOOOOOGOOOOOOOOOOOOOOOOOOOOAGOOOOOOOOOOOOOOOOOOOOOGOOOOOOOOOOOOOOOOOOOOOGOOOOOOOOOOOOOOOOOOOOOGOOOOOOOOOOOOOOOOOOOOOGOOOOOOOOOOOOOOOOOOOOOGOOOOOOOOOOOOOOOOAXXXXGOOOOOOOOOOOOOOOOOOOOOGOOOOOOOOOOOOOOOOOXXXX,0,0,0

8925,278,3,275,136,186,0,0,461,385,76,GOOOOOOOOOOOOOOOOOOOOOGOOOOOOOOOOOOOOOOOOOOOGOOOOOOOOOOOOOOOOOOOAAGOOOOOOOOOOOOOOOOOOOOOGOOOOOOOOOOOOOOOOOOOOAGOOOOOOOOOOOOOOOOOOOOOGOOOOOOOOOOOOOOOOOOOOOGOOOOOOOOOOOOOOOOOOOOOGOOOOOOOOOOOOOOOOOOOOOGOOOOOOOOOOOOOOOOOOOOOGOOOOOOOOOOOOOOOOOXXXXGOOOOOOOOOOOOOOOOOOOOOGOOOOOOOOOOOOOOOOOXXXX,0,0,0
8946,280,5,275,135,185,0,0,460,390,70,GOOOOOOOOOOOOOOOOOOOOOGOOOOOOOOOOOOOOOOOOOOOGOOOOOOOOOOOOOOOOOOOAAGOOOOOOOOOOOOOOOOOOOOOGOOOOOOOOOOOOOOOOOOOOAGOOOOOOOOOOOOOOOOOOOOOGOOOOOOOOOOOOOOOOOOOOOGOOOOOOOOOOOOOOOOOOOOOGOOOOOOOOOOOOOOOOOOOOOGOOOOOOOOOOOOOOOOOOOOOGOOOOOOOOOOOOOOOOOAAXXGOOOOOOOOOOOOOOOOOOOOOGOOOOOOOOOOOOOOOOOXXXX,0,0,0
8967,280,5,275,134,186,0,0,461,390,71,GOOOOOOOOOOOOOOOOOOOOOGOOOOOOOOOOOOOOOOOOOOOGOOOOOOOOOOOOOOOOOOOAAGOOOOOOOOOOOOOOOOOOOOOGOOOOOOOOOOOOOOOOOOOOAGOOOOOOOOOOOOOOOOOOOOOGOOOOOOOOOOOOOOOOOOOOOGOOOOOOOOOOOOOOOOOOOOOGOOOOOOOOOOOOOOOOOOOOOGOOOOOOOOOOOOOOOOOOOOOGOOOOOOOOOOOOOOOOOAAXXGOOOOOOOOOOOOOOOOOOOOOGOOOOOOOOOOOOOOOOOXXXX,0,0,0
8988,280,5,275,130,190,0,0,465,388,77,GOOOOOOOOOOOOOOOOOOOOOGOOOOOOOOOOOOOOOOOOOOOGOOOOOOOOOOOOOOOOOOOAAGOOOOOOOOOOOOOOOOOOOOOGOOOOOOOOOOOOOOOOOOOOAGOOOOOOOOOOOOOOOOOOOOOGOOOOOOOOOOOOOOOOOOOOOGOOOOOOOOOOOOOOOOOOOOOGOOOOOOOOOOOOOOOOOOOOOGOOOOOOOOOOOOOOOOOOOOOGOOOOOOOOOOOOOOOOOAAXXGOOOOOOOOOOOOOOOOOOOOOGOOOOOOOOOOOOOOOOOXXXX,0,0,0
9009,280,5,275,133,187,0,0,462,386,76,GOOOOOOOOOOOOOOOOOOOOOGOOOOOOOOOOOOOOOOOOOOOGOOOOOOOOOOOOOOOOOOOAAGOOOOOOOOOOOOOOOOOOOOOGOOOOOOOOOOOOOOOOOOOOAGOOOOOOOOOOOOOOOOOOOOOGOOOOOOOOOOOOOOOOOOOOOGOOOOOOOOOOOOOOOOOOOOOGOOOOOOOOOOOOOOOOOOOOOGOOOOOOOOOOOOOOOOOOOOOGOOOOOOOOOOOOOOOOOAAXXGOOOOOOOOOOOOOOOOOOOOOGOOOOOOOOOOOOOOOOOXXXX,0,0,0

9030,280,5,275,128,192,0,0,467,388,79,GOOOOOOOOOOOOOOOOOOOOOGOOOOOOOOOOOOOOOOOOOOOGOOOOOOOOOOOOOOOOOOOAAGOOOOOOOOOOOOOOOOOOOOOGOOOOOOOOOOOOOOOOOOOOAGOOOOOOOOOOOOOOOOOOOOOGOOOOOOOOOOOOOOOOOOOOOGOOOOOOOOOOOOOOOOOOOOOGOOOOOOOOOOOOOOOOOOOOOGOOOOOOOOOOOOOOOOOOOOOGOOOOOOOOOOOOOOOOOAAXXGOOOOOOOOOOOOOOOOOOOOOGOOOOOOOOOOOOOOOOOXXXX,0,0,0
9051,280,5,275,126,194,0,0,469,392,77,GOOOOOOOOOOOOOOOOOOOOOGOOOOOOOOOOOOOOOOOOOOOGOOOOOOOOOOOOOOOOOOOAAGOOOOOOOOOOOOOOOOOOOOOGOOOOOOOOOOOOOOOOOOOOAGOOOOOOOOOOOOOOOOOOOOOGOOOOOOOOOOOOOOOOOOOOOGOOOOOOOOOOOOOOOOOOOOOGOOOOOOOOOOOOOOOOOOOOOGOOOOOOOOOOOOOOOOOOOOOGOOOOOOOOOOOOOOOOOAAXXGOOOOOOOOOOOOOOOOOOOOOGOOOOOOOOOOOOOOOOOXXXX,0,0,0
9072,280,5,275,128,192,0,0,467,392,75,GOOOOOOOOOOOOOOOOOOOOOGOOOOOOOOOOOOOOOOOOOOOGOOOOOOOOOOOOOOOOOOOAAGOOOOOOOOOOOOOOOOOOOOOGOOOOOOOOOOOOOOOOOOOOAGOOOOOOOOOOOOOOOOOOOOOGOOOOOOOOOOOOOOOOOOOOOGOOOOOOOOOOOOOOOOOOOOOGOOOOOOOOOOOOOOOOOOOOOGOOOOOOOOOOOOOOOOOOOOOGOOOOOOOOOOOOOOOOOAAXXGOOOOOOOOOOOOOOOOOOOOOGOOOOOOOOOOOOOOOOOXXXX,0,0,0
9093,280,4,276,130,190,0,0,466,388,78,GOOOOOOOOOOOOOOOOOOOOOGOOOOOOOOOOOOOOOOOOOOOGOOOOOOOOOOOOOOOOOOOAOGOOOOOOOOOOOOOOOOOOOOOGOOOOOOOOOOOOOOOOOOOOAGOOOOOOOOOOOOOOOOOOOOOGOOOOOOOOOOOOOOOOOOOOOGOOOOOOOOOOOOOOOOOOOOOGOOOOOOOOOOOOOOOOOOOOOGOOOOOOOOOOOOOOOOOOOOOGOOOOOOOOOOOOOOOOOAAXXGOOOOOOOOOOOOOOOOOOOOOGOOOOOOOOOOOOOOOOOXXXX,0,0,0
9114,280,4,276,129,191,0,0,467,391,76,GOOOOOOOOOOOOOOOOOOOOOGOOOOOOOOOOOOOOOOOOOOOGOOOOOOOOOOOOOOOOOOOAOGOOOOOOOOOOOOOOOOOOOOOGOOOOOOOOOOOOOOOOOOOOAGOOOOOOOOOOOOOOOOOOOOOGOOOOOOOOOOOOOOOOOOOOOGOOOOOOOOOOOOOOOOOOOOOGOOOOOOOOOOOOOOOOOOOOOGOOOOOOOOOOOOOOOOOOOOOGOOOOOOOOOOOOOOOOOAAXXGOOOOOOOOOOOOOOOOOOOOOGOOOOOOOOOOOOOOOOOXXXX,0,0,0

9135,282,5,277,133,185,0,0,462,388,74,GOOOOOOOOOOOOOOOOOOOOOGOOOOOOOOOOOOOOOOOOOOOGOOOOOOOOOOOOOOOOOOOAOGOOOOOOOOOOOOOOOOOOOOOGOOOOOOOOOOOOOOOOOOOOOGOOOOOOOOOOOOOOOOOOOOOGOOOOOOOOOOOOOOOOOOOOOGOOOOOOOOOOOOOOOOOOOOOGOOOOOOOOOOOOOOOOOOOOOGOOOOOOOOOOOOOOOOOOOOOGOOOOOOOOOOOOOOOOOAAAAGOOOOOOOOOOOOOOOOOOOOOGOOOOOOOOOOOOOOOOOXXXX,0,0,0
9156,282,5,277,130,188,0,0,465,390,75,GOOOOOOOOOOOOOOOOOOOOOGOOOOOOOOOOOOOOOOOOOOOGOOOOOOOOOOOOOOOOOOOAOGOOOOOOOOOOOOOOOOOOOOOGOOOOOOOOOOOOOOOOOOOOOGOOOOOOOOOOOOOOOOOOOOOGOOOOOOOOOOOOOOOOOOOOOGOOOOOOOOOOOOOOOOOOOOOGOOOOOOOOOOOOOOOOOOOOOGOOOOOOOOOOOOOOOOOOOOOGOOOOOOOOOOOOOOOOOAAAAGOOOOOOOOOOOOOOOOOOOOOGOOOOOOOOOOOOOOOOOXXXX,0,0,0
9177,282,5,277,129,189,0,0,466,390,76,GOOOOOOOOOOOOOOOOOOOOOGOOOOOOOOOOOOOOOOOOOOOGOOOOOOOOOOOOOOOOOOOAOGOOOOOOOOOOOOOOOOOOOOOGOOOOOOOOOOOOOOOOOOOOOGOOOOOOOOOOOOOOOOOOOOOGOOOOOOOOOOOOOOOOOOOOOGOOOOOOOOOOOOOOOOOOOOOGOOOOOOOOOOOOOOOOOOOOOGOOOOOOOOOOOOOOOOOOOOOGOOOOOOOOOOOOOOOOOAAAAGOOOOOOOOOOOOOOOOOOOOOGOOOOOOOOOOOOOOOOOXXXX,0,0,0
9198,282,5,277,132,186,0,0,463,388,75,GOOOOOOOOOOOOOOOOOOOOOGOOOOOOOOOOOOOOOOOOOOOGOOOOOOOOOOOOOOOOOOOAOGOOOOOOOOOOOOOOOOOOOOOGOOOOOOOOOOOOOOOOOOOOOGOOOOOOOOOOOOOOOOOOOOOGOOOOOOOOOOOOOOOOOOOOOGOOOOOOOOOOOOOOOOOOOOOGOOOOOOOOOOOOOOOOOOOOOGOOOOOOOOOOOOOOOOOOOOOGOOOOOOOOOOOOOOOOOAAAAGOOOOOOOOOOOOOOOOOOOOOGOOOOOOOOOOOOOOOOOXXXX,0,0,0
9219,282,4,278,136,182,0,0,459,384,75,GOOOOOOOOOOOOOOOOOOOOOGOOOOOOOOOOOOOOOOOOOOOGOOOOOOOOOOOOOOOOOOOAOGOOOOOOOOOOOOOOOOOOOOOGOOOOOOOOOOOOOOOOOOOOOGOOOOOOOOOOOOOOOOOOOOOGOOOOOOOOOOOOOOOOOOOOOGOOOOOOOOOOOOOOOOOOOOOGOOOOOOOOOOOOOOOOOOOOOGOOOOOOOOOOOOOOOOOOOOOGOOOOOOOOOOOOOOOOOOAAAGOOOOOOOOOOOOOOOOOOOOOGOOOOOOOOOOOOOOOOOXXXX,0,0,0

9240,282,4,278,138,180,0,0,458,386,72,GOOOOOOOOOOOOOOOOOOOOOGOOOOOOOOOOOOOOOOOOOOOGOOOOOOOOOOOOOOOOOOOAOGOOOOOOOOOOOOOOOOOOOOOGOOOOOOOOOOOOOOOOOOOOOGOOOOOOOOOOOOOOOOOOOOOGOOOOOOOOOOOOOOOOOOOOOGOOOOOOOOOOOOOOOOOOOOOGOOOOOOOOOOOOOOOOOOOOOGOOOOOOOOOOOOOOOOOOOOOGOOOOOOOOOOOOOOOOOOAAAGOOOOOOOOOOOOOOOOOOOOOGOOOOOOOOOOOOOOOOOXXXX,0,0,0
9261,282,4,278,141,177,0,0,455,385,70,GOOOOOOOOOOOOOOOOOOOOOGOOOOOOOOOOOOOOOOOOOOOGOOOOOOOOOOOOOOOOOOOAOGOOOOOOOOOOOOOOOOOOOOOGOOOOOOOOOOOOOOOOOOOOOGOOOOOOOOOOOOOOOOOOOOOGOOOOOOOOOOOOOOOOOOOOOGOOOOOOOOOOOOOOOOOOOOOGOOOOOOOOOOOOOOOOOOOOOGOOOOOOOOOOOOOOOOOOOOOGOOOOOOOOOOOOOOOOOOAAAGOOOOOOOOOOOOOOOOOOOOOGOOOOOOOOOOOOOOOOOXXXX,0,0,0
9282,282,4,278,143,175,0,0,453,381,72,GOOOOOOOOOOOOOOOOOOOOOGOOOOOOOOOOOOOOOOOOOOOGOOOOOOOOOOOOOOOOOOOAOGOOOOOOOOOOOOOOOOOOOOOGOOOOOOOOOOOOOOOOOOOOOGOOOOOOOOOOOOOOOOOOOOOGOOOOOOOOOOOOOOOOOOOOOGOOOOOOOOOOOOOOOOOOOOOGOOOOOOOOOOOOOOOOOOOOOGOOOOOOOOOOOOOOOOOOOOOGOOOOOOOOOOOOOOOOOOAAAGOOOOOOOOOOOOOOOOOOOOOGOOOOOOOOOOOOOOOOOXXXX,0,0,0
9303,282,3,279,145,173,0,0,451,386,65,GOOOOOOOOOOOOOOOOOOOOOGOOOOOOOOOOOOOOOOOOOOOGOOOOOOOOOOOOOOOOOOOAOGOOOOOOOOOOOOOOOOOOOOOGOOOOOOOOOOOOOOOOOOOOOGOOOOOOOOOOOOOOOOOOOOOGOOOOOOOOOOOOOOOOOOOOOGOOOOOOOOOOOOOOOOOOOOOGOOOOOOOOOOOOOOOOOOOOOGOOOOOOOOOOOOOOOOOOOOOGOOOOOOOOOOOOOOOOOOOAAGOOOOOOOOOOOOOOOOOOOOOGOOOOOOOOOOOOOOOOOXXXX,0,0,0
9324,282,3,279,144,174,0,0,452,389,63,GOOOOOOOOOOOOOOOOOOOOOGOOOOOOOOOOOOOOOOOOOOOGOOOOOOOOOOOOOOOOOOOAOGOOOOOOOOOOOOOOOOOOOOOGOOOOOOOOOOOOOOOOOOOOOGOOOOOOOOOOOOOOOOOOOOOGOOOOOOOOOOOOOOOOOOOOOGOOOOOOOOOOOOOOOOOOOOOGOOOOOOOOOOOOOOOOOOOOOGOOOOOOOOOOOOOOOOOOOOOGOOOOOOOOOOOOOOOOOOOAAGOOOOOOOOOOOOOOOOOOOOOGOOOOOOOOOOOOOOOOOXXXX,0,0,0

9345,282,3,279,146,172,0,0,451,389,62,GOOOOOOOOOOOOOOOOOOOOOGOOOOOOOOOOOOOOOOOOOOOGOOOOOOOOOOOOOOOOOOOAOGOOOOOOOOOOOOOOOOOOOOOGOOOOOOOOOOOOOOOOOOOOOGOOOOOOOOOOOOOOOOOOOOOGOOOOOOOOOOOOOOOOOOOOOGOOOOOOOOOOOOOOOOOOOOOGOOOOOOOOOOOOOOOOOOOOOGOOOOOOOOOOOOOOOOOOOOOGOOOOOOOOOOOOOOOOOOOAAGOOOOOOOOOOOOOOOOOOOOOGOOOOOOOOOOOOOOOOOXXXX,0,0,0
9366,282,3,279,147,171,0,0,450,389,61,GOOOOOOOOOOOOOOOOOOOOOGOOOOOOOOOOOOOOOOOOOOOGOOOOOOOOOOOOOOOOOOOAOGOOOOOOOOOOOOOOOOOOOOOGOOOOOOOOOOOOOOOOOOOOOGOOOOOOOOOOOOOOOOOOOOOGOOOOOOOOOOOOOOOOOOOOOGOOOOOOOOOOOOOOOOOOOOOGOOOOOOOOOOOOOOOOOOOOOGOOOOOOOOOOOOOOOOOOOOOGOOOOOOOOOOOOOOOOOOOAAGOOOOOOOOOOOOOOOOOOOOOGOOOOOOOOOOOOOOOOOXXXX,0,0,0
9387,282,3,279,150,168,0,0,447,389,58,GOOOOOOOOOOOOOOOOOOOOOGOOOOOOOOOOOOOOOOOOOOOGOOOOOOOOOOOOOOOOOOOAOGOOOOOOOOOOOOOOOOOOOOOGOOOOOOOOOOOOOOOOOOOOOGOOOOOOOOOOOOOOOOOOOOOGOOOOOOOOOOOOOOOOOOOOOGOOOOOOOOOOOOOOOOOOOOOGOOOOOOOOOOOOOOOOOOOOOGOOOOOOOOOOOOOOOOOOOOOGOOOOOOOOOOOOOOOOOOOAAGOOOOOOOOOOOOOOOOOOOOOGOOOOOOOOOOOOOOOOOXXXX,0,0,0
9408,282,3,279,152,166,0,0,445,389,56,GOOOOOOOOOOOOOOOOOOOOOGOOOOOOOOOOOOOOOOOOOOOGOOOOOOOOOOOOOOOOOOOAOGOOOOOOOOOOOOOOOOOOOOOGOOOOOOOOOOOOOOOOOOOOOGOOOOOOOOOOOOOOOOOOOOOGOOOOOOOOOOOOOOOOOOOOOGOOOOOOOOOOOOOOOOOOOOOGOOOOOOOOOOOOOOOOOOOOOGOOOOOOOOOOOOOOOOOOOOOGOOOOOOOOOOOOOOOOOOOAAGOOOOOOOOOOOOOOOOOOOOOGOOOOOOOOOOOOOOOOOXXXX,0,0,0
9429,282,3,279,152,166,0,0,445,392,53,GOOOOOOOOOOOOOOOOOOOOOGOOOOOOOOOOOOOOOOOOOOOGOOOOOOOOOOOOOOOOOOOAOGOOOOOOOOOOOOOOOOOOOOOGOOOOOOOOOOOOOOOOOOOOOGOOOOOOOOOOOOOOOOOOOOOGOOOOOOOOOOOOOOOOOOOOOGOOOOOOOOOOOOOOOOOOOOOGOOOOOOOOOOOOOOOOOOOOOGOOOOOOOOOOOOOOOOOOOOOGOOOOOOOOOOOOOOOOOOOAAGOOOOOOOOOOOOOOOOOOOOOGOOOOOOOOOOOOOOOOOXXXX,0,0,0

9450,282,2,280,150,168,0,0,448,391,57,GOOOOOOOOOOOOOOOOOOOOOGOOOOOOOOOOOOOOOOOOOOOGOOOOOOOOOOOOOOOOOOOOOGOOOOOOOOOOOOOOOOOOOOOGOOOOOOOOOOOOOOOOOOOOOGOOOOOOOOOOOOOOOOOOOOOGOOOOOOOOOOOOOOOOOOOOOGOOOOOOOOOOOOOOOOOOOOOGOOOOOOOOOOOOOOOOOOOOOGOOOOOOOOOOOOOOOOOOOOOGOOOOOOOOOOOOOOOOOOOAAGOOOOOOOOOOOOOOOOOOOOOGOOOOOOOOOOOOOOOOOXXXX,0,0,0
9471,282,2,280,149,169,0,0,449,399,50,GOOOOOOOOOOOOOOOOOOOOOGOOOOOOOOOOOOOOOOOOOOOGOOOOOOOOOOOOOOOOOOOOOGOOOOOOOOOOOOOOOOOOOOOGOOOOOOOOOOOOOOOOOOOOOGOOOOOOOOOOOOOOOOOOOOOGOOOOOOOOOOOOOOOOOOOOOGOOOOOOOOOOOOOOOOOOOOOGOOOOOOOOOOOOOOOOOOOOOGOOOOOOOOOOOOOOOOOOOOOGOOOOOOOOOOOOOOOOOOOAAGOOOOOOOOOOOOOOOOOOOOOGOOOOOOOOOOOOOOOOOXXXX,0,0,0
9492,283,3,280,148,169,0,0,448,400,48,GOOOOOOOOOOOOOOOOOOOOOGOOOOOOOOOOOOOOOOOOOOOGOOOOOOOOOOOOOOOOOOOOOGOOOOOOOOOOOOOOOOOOOOOGOOOOOOOOOOOOOOOOOOOOOGOOOOOOOOOOOOOOOOOOOOOGOOOOOOOOOOOOOOOOOOOOOGOOOOOOOOOOOOOOOOOOOOOGOOOOOOOOOOOOOOOOOOOOOGOOOOOOOOOOOOOOOOOOOOOGOOOOOOOOOOOOOOOOOOOAAGOOOOOOOOOOOOOOOOOOOOOGOOOOOOOOOOOOOOOOOAXXX,0,0,0
9513,283,3,280,147,170,0,0,450,400,50,GOOOOOOOOOOOOOOOOOOOOOGOOOOOOOOOOOOOOOOOOOOOGOOOOOOOOOOOOOOOOOOOOOGOOOOOOOOOOOOOOOOOOOOOGOOOOOOOOOOOOOOOOOOOOOGOOOOOOOOOOOOOOOOOOOOOGOOOOOOOOOOOOOOOOOOOOOGOOOOOOOOOOOOOOOOOOOOOGOOOOOOOOOOOOOOOOOOOOOGOOOOOOOOOOOOOOOOOOOOOGOOOOOOOOOOOOOOOOOOOAAGOOOOOOOOOOOOOOOOOOOOOGOOOOOOOOOOOOOOOOOAXXX,0,0,0
9534,284,4,280,145,171,0,0,451,396,55,GOOOOOOOOOOOOOOOOOOOOOGOOOOOOOOOOOOOOOOOOOOOGOOOOOOOOOOOOOOOOOOOOOGOOOOOOOOOOOOOOOOOOOOOGOOOOOOOOOOOOOOOOOOOOOGOOOOOOOOOOOOOOOOOOOOOGOOOOOOOOOOOOOOOOOOOOOGOOOOOOOOOOOOOOOOOOOOOGOOOOOOOOOOOOOOOOOOOOOGOOOOOOOOOOOOOOOOOOOOOGOOOOOOOOOOOOOOOOOOOAAGOOOOOOOOOOOOOOOOOOOOOGOOOOOOOOOOOOOOOOOAAXX,0,0,0

9555,284,4,280,145,171,0,0,451,397,54,GOOOOOOOOOOOOOOOOOOOOOGOOOOOOOOOOOOOOOOOOOOOGOOOOOOOOOOOOOOOOOOOOOGOOOOOOOOOOOOOOOOOOOOOGOOOOOOOOOOOOOOOOOOOOOGOOOOOOOOOOOOOOOOOOOOOGOOOOOOOOOOOOOOOOOOOOOGOOOOOOOOOOOOOOOOOOOOOGOOOOOOOOOOOOOOOOOOOOOGOOOOOOOOOOOOOOOOOOOOOGOOOOOOOOOOOOOOOOOOOAAGOOOOOOOOOOOOOOOOOOOOOGOOOOOOOOOOOOOOOOOAAXX,0,0,0
9576,286,6,280,141,173,0,0,453,394,59,GOOOOOOOOOOOOOOOOOOOOOGOOOOOOOOOOOOOOOOOOOOOGOOOOOOOOOOOOOOOOOOOOOGOOOOOOOOOOOOOOOOOOOOOGOOOOOOOOOOOOOOOOOOOOOGOOOOOOOOOOOOOOOOOOOOOGOOOOOOOOOOOOOOOOOOOOOGOOOOOOOOOOOOOOOOOOOOOGOOOOOOOOOOOOOOOOOOOOOGOOOOOOOOOOOOOOOOOOOOOGOOOOOOOOOOOOOOOOOOOAAGOOOOOOOOOOOOOOOOOOOOOGOOOOOOOOOOOOOOOOOAAAA,0,0,0
9597,286,6,280,142,172,0,0,452,391,61,GOOOOOOOOOOOOOOOOOOOOOGOOOOOOOOOOOOOOOOOOOOOGOOOOOOOOOOOOOOOOOOOOOGOOOOOOOOOOOOOOOOOOOOOGOOOOOOOOOOOOOOOOOOOOOGOOOOOOOOOOOOOOOOOOOOOGOOOOOOOOOOOOOOOOOOOOOGOOOOOOOOOOOOOOOOOOOOOGOOOOOOOOOOOOOOOOOOOOOGOOOOOOOOOOOOOOOOOOOOOGOOOOOOOOOOOOOOOOOOOAAGOOOOOOOOOOOOOOOOOOOOOGOOOOOOOOOOOOOOOOOAAAA,0,0,0
9618,286,6,280,140,174,0,0,453,389,64,GOOOOOOOOOOOOOOOOOOOOOGOOOOOOOOOOOOOOOOOOOOOGOOOOOOOOOOOOOOOOOOOOOGOOOOOOOOOOOOOOOOOOOOOGOOOOOOOOOOOOOOOOOOOOOGOOOOOOOOOOOOOOOOOOOOOGOOOOOOOOOOOOOOOOOOOOOGOOOOOOOOOOOOOOOOOOOOOGOOOOOOOOOOOOOOOOOOOOOGOOOOOOOOOOOOOOOOOOOOOGOOOOOOOOOOOOOOOOOOOAAGOOOOOOOOOOOOOOOOOOOOOGOOOOOOOOOOOOOOOOOAAAA,0,0,0
9639,286,5,281,145,169,0,0,450,382,68,GOOOOOOOOOOOOOOOOOOOOOGOOOOOOOOOOOOOOOOOOOOOGOOOOOOOOOOOOOOOOOOOOOGOOOOOOOOOOOOOOOOOOOOOGOOOOOOOOOOOOOOOOOOOOOGOOOOOOOOOOOOOOOOOOOOOGOOOOOOOOOOOOOOOOOOOOOGOOOOOOOOOOOOOOOOOOOOOGOOOOOOOOOOOOOOOOOOOOOGOOOOOOOOOOOOOOOOOOOOOGOOOOOOOOOOOOOOOOOOOAAGOOOOOOOOOOOOOOOOOOOOOGOOOOOOOOOOOOOOOOOAAOA,0,0,0

9660,286,5,281,143,171,0,0,451,382,69,GOOOOOOOOOOOOOOOOOOOOOGOOOOOOOOOOOOOOOOOOOOOGOOOOOOOOOOOOOOOOOOOOOGOOOOOOOOOOOOOOOOOOOOOGOOOOOOOOOOOOOOOOOOOOOGOOOOOOOOOOOOOOOOOOOOOGOOOOOOOOOOOOOOOOOOOOOGOOOOOOOOOOOOOOOOOOOOOGOOOOOOOOOOOOOOOOOOOOOGOOOOOOOOOOOOOOOOOOOOOGOOOOOOOOOOOOOOOOOOOAAGOOOOOOOOOOOOOOOOOOOOOGOOOOOOOOOOOOOOOOOAAOA,0,0,0
9681,286,5,281,140,174,0,0,455,378,77,GOOOOOOOOOOOOOOOOOOOOOGOOOOOOOOOOOOOOOOOOOOOGOOOOOOOOOOOOOOOOOOOOOGOOOOOOOOOOOOOOOOOOOOOGOOOOOOOOOOOOOOOOOOOOOGOOOOOOOOOOOOOOOOOOOOOGOOOOOOOOOOOOOOOOOOOOOGOOOOOOOOOOOOOOOOOOOOOGOOOOOOOOOOOOOOOOOOOOOGOOOOOOOOOOOOOOOOOOOOOGOOOOOOOOOOOOOOOOOOOAAGOOOOOOOOOOOOOOOOOOOOOGOOOOOOOOOOOOOOOOOAAOA,0,0,0
9702,286,5,281,140,174,0,0,455,379,76,GOOOOOOOOOOOOOOOOOOOOOGOOOOOOOOOOOOOOOOOOOOOGOOOOOOOOOOOOOOOOOOOOOGOOOOOOOOOOOOOOOOOOOOOGOOOOOOOOOOOOOOOOOOOOOGOOOOOOOOOOOOOOOOOOOOOGOOOOOOOOOOOOOOOOOOOOOGOOOOOOOOOOOOOOOOOOOOOGOOOOOOOOOOOOOOOOOOOOOGOOOOOOOOOOOOOOOOOOOOOGOOOOOOOOOOOOOOOOOOOAAGOOOOOOOOOOOOOOOOOOOOOGOOOOOOOOOOOOOOOOOAAOA,0,0,0
9723,286,5,281,138,176,0,0,457,378,79,GOOOOOOOOOOOOOOOOOOOOOGOOOOOOOOOOOOOOOOOOOOOGOOOOOOOOOOOOOOOOOOOOOGOOOOOOOOOOOOOOOOOOOOOGOOOOOOOOOOOOOOOOOOOOOGOOOOOOOOOOOOOOOOOOOOOGOOOOOOOOOOOOOOOOOOOOOGOOOOOOOOOOOOOOOOOOOOOGOOOOOOOOOOOOOOOOOOOOOGOOOOOOOOOOOOOOOOOOOOOGOOOOOOOOOOOOOOOOOOOAAGOOOOOOOOOOOOOOOOOOOOOGOOOOOOOOOOOOOOOOOAAOA,0,0,0
9744,286,4,282,137,177,0,0,459,376,83,GOOOOOOOOOOOOOOOOOOOOOGOOOOOOOOOOOOOOOOOOOOOGOOOOOOOOOOOOOOOOOOOOOGOOOOOOOOOOOOOOOOOOOOOGOOOOOOOOOOOOOOOOOOOOOGOOOOOOOOOOOOOOOOOOOOOGOOOOOOOOOOOOOOOOOOOOOGOOOOOOOOOOOOOOOOOOOOOGOOOOOOOOOOOOOOOOOOOOOGOOOOOOOOOOOOOOOOOOOOOGOOOOOOOOOOOOOOOOOOOOAGOOOOOOOOOOOOOOOOOOOOOGOOOOOOOOOOOOOOOOOAAOA,0,0,0

9765,286,3,283,139,175,0,0,458,377,81,GOOOOOOOOOOOOOOOOOOOOOGOOOOOOOOOOOOOOOOOOOOOGOOOOOOOOOOOOOOOOOOOOOGOOOOOOOOOOOOOOOOOOOOOGOOOOOOOOOOOOOOOOOOOOOGOOOOOOOOOOOOOOOOOOOOOGOOOOOOOOOOOOOOOOOOOOOGOOOOOOOOOOOOOOOOOOOOOGOOOOOOOOOOOOOOOOOOOOOGOOOOOOOOOOOOOOOOOOOOOGOOOOOOOOOOOOOOOOOOOOOGOOOOOOOOOOOOOOOOOOOOOGOOOOOOOOOOOOOOOOOAAOA,0,0,0
9786,286,3,283,141,173,0,0,456,377,79,GOOOOOOOOOOOOOOOOOOOOOGOOOOOOOOOOOOOOOOOOOOOGOOOOOOOOOOOOOOOOOOOOOGOOOOOOOOOOOOOOOOOOOOOGOOOOOOOOOOOOOOOOOOOOOGOOOOOOOOOOOOOOOOOOOOOGOOOOOOOOOOOOOOOOOOOOOGOOOOOOOOOOOOOOOOOOOOOGOOOOOOOOOOOOOOOOOOOOOGOOOOOOOOOOOOOOOOOOOOOGOOOOOOOOOOOOOOOOOOOOOGOOOOOOOOOOOOOOOOOOOOOGOOOOOOOOOOOOOOOOOAAOA,0,0,0
9807,286,3,283,147,167,0,0,449,373,76,GOOOOOOOOOOOOOOOOOOOOOGOOOOOOOOOOOOOOOOOOOOOGOOOOOOOOOOOOOOOOOOOOOGOOOOOOOOOOOOOOOOOOOOOGOOOOOOOOOOOOOOOOOOOOOGOOOOOOOOOOOOOOOOOOOOOGOOOOOOOOOOOOOOOOOOOOOGOOOOOOOOOOOOOOOOOOOOOGOOOOOOOOOOOOOOOOOOOOOGOOOOOOOOOOOOOOOOOOOOOGOOOOOOOOOOOOOOOOOOOOOGOOOOOOOOOOOOOOOOOOOOOGOOOOOOOOOOOOOOOOOAAOA,0,0,0
9828,286,3,283,149,165,0,0,448,368,80,GOOOOOOOOOOOOOOOOOOOOOGOOOOOOOOOOOOOOOOOOOOOGOOOOOOOOOOOOOOOOOOOOOGOOOOOOOOOOOOOOOOOOOOOGOOOOOOOOOOOOOOOOOOOOOGOOOOOOOOOOOOOOOOOOOOOGOOOOOOOOOOOOOOOOOOOOOGOOOOOOOOOOOOOOOOOOOOOGOOOOOOOOOOOOOOOOOOOOOGOOOOOOOOOOOOOOOOOOOOOGOOOOOOOOOOOOOOOOOOOOOGOOOOOOOOOOOOOOOOOOOOOGOOOOOOOOOOOOOOOOOAAOA,0,0,0
9849,286,2,284,145,169,0,0,453,375,78,GOOOOOOOOOOOOOOOOOOOOOGOOOOOOOOOOOOOOOOOOOOOGOOOOOOOOOOOOOOOOOOOOOGOOOOOOOOOOOOOOOOOOOOOGOOOOOOOOOOOOOOOOOOOOOGOOOOOOOOOOOOOOOOOOOOOGOOOOOOOOOOOOOOOOOOOOOGOOOOOOOOOOOOOOOOOOOOOGOOOOOOOOOOOOOOOOOOOOOGOOOOOOOOOOOOOOOOOOOOOGOOOOOOOOOOOOOOOOOOOOOGOOOOOOOOOOOOOOOOOOOOOGOOOOOOOOOOOOOOOOOAOOA,0,0,0

9870,286,2,284,146,168,0,0,452,376,76,GOOOOOOOOOOOOOOOOOOOOOGOOOOOOOOOOOOOOOOOOOOOGOOOOOOOOOOOOOOOOOOOOOGOOOOOOOOOOOOOOOOOOOOOGOOOOOOOOOOOOOOOOOOOOOGOOOOOOOOOOOOOOOOOOOOOGOOOOOOOOOOOOOOOOOOOOOGOOOOOOOOOOOOOOOOOOOOOGOOOOOOOOOOOOOOOOOOOOOGOOOOOOOOOOOOOOOOOOOOOGOOOOOOOOOOOOOOOOOOOOOGOOOOOOOOOOOOOOOOOOOOOGOOOOOOOOOOOOOOOOOAOOA,0,0,0
9891,286,2,284,150,164,0,0,448,376,72,GOOOOOOOOOOOOOOOOOOOOOGOOOOOOOOOOOOOOOOOOOOOGOOOOOOOOOOOOOOOOOOOOOGOOOOOOOOOOOOOOOOOOOOOGOOOOOOOOOOOOOOOOOOOOOGOOOOOOOOOOOOOOOOOOOOOGOOOOOOOOOOOOOOOOOOOOOGOOOOOOOOOOOOOOOOOOOOOGOOOOOOOOOOOOOOOOOOOOOGOOOOOOOOOOOOOOOOOOOOOGOOOOOOOOOOOOOOOOOOOOOGOOOOOOOOOOOOOOOOOOOOOGOOOOOOOOOOOOOOOOOAOOA,0,0,0
9912,286,2,284,148,166,0,0,449,378,71,GOOOOOOOOOOOOOOOOOOOOOGOOOOOOOOOOOOOOOOOOOOOGOOOOOOOOOOOOOOOOOOOOOGOOOOOOOOOOOOOOOOOOOOOGOOOOOOOOOOOOOOOOOOOOOGOOOOOOOOOOOOOOOOOOOOOGOOOOOOOOOOOOOOOOOOOOOGOOOOOOOOOOOOOOOOOOOOOGOOOOOOOOOOOOOOOOOOOOOGOOOOOOOOOOOOOOOOOOOOOGOOOOOOOOOOOOOOOOOOOOOGOOOOOOOOOOOOOOOOOOOOOGOOOOOOOOOOOOOOOOOAOOA,0,0,0
9933,286,1,285,143,171,0,0,455,383,72,GOOOOOOOOOOOOOOOOOOOOOGOOOOOOOOOOOOOOOOOOOOOGOOOOOOOOOOOOOOOOOOOOOGOOOOOOOOOOOOOOOOOOOOOGOOOOOOOOOOOOOOOOOOOOOGOOOOOOOOOOOOOOOOOOOOOGOOOOOOOOOOOOOOOOOOOOOGOOOOOOOOOOOOOOOOOOOOOGOOOOOOOOOOOOOOOOOOOOOGOOOOOOOOOOOOOOOOOOOOOGOOOOOOOOOOOOOOOOOOOOOGOOOOOOOOOOOOOOOOOOOOOGOOOOOOOOOOOOOOOOOAOOO,0,0,0
9954,286,1,285,142,172,0,0,457,387,70,GOOOOOOOOOOOOOOOOOOOOOGOOOOOOOOOOOOOOOOOOOOOGOOOOOOOOOOOOOOOOOOOOOGOOOOOOOOOOOOOOOOOOOOOGOOOOOOOOOOOOOOOOOOOOOGOOOOOOOOOOOOOOOOOOOOOGOOOOOOOOOOOOOOOOOOOOOGOOOOOOOOOOOOOOOOOOOOOGOOOOOOOOOOOOOOOOOOOOOGOOOOOOOOOOOOOOOOOOOOOGOOOOOOOOOOOOOOOOOOOOOGOOOOOOOOOOOOOOOOOOOOOGOOOOOOOOOOOOOOOOOAOOO,0,0,0

9975,286,1,285,139,175,0,0,459,386,73,GOOOOOOOOOOOOOOOOOOOOOGOOOOOOOOOOOOOOOOOOOOOGOOOOOOOOOOOOOOOOOOOOOGOOOOOOOOOOOOOOOOOOOOOGOOOOOOOOOOOOOOOOOOOOOGOOOOOOOOOOOOOOOOOOOOOGOOOOOOOOOOOOOOOOOOOOOGOOOOOOOOOOOOOOOOOOOOOGOOOOOOOOOOOOOOOOOOOOOGOOOOOOOOOOOOOOOOOOOOOGOOOOOOOOOOOOOOOOOOOOOGOOOOOOOOOOOOOOOOOOOOOGOOOOOOOOOOOOOOOOOAOOO,0,0,0
9996,286,1,285,137,177,0,0,462,386,76,GOOOOOOOOOOOOOOOOOOOOOGOOOOOOOOOOOOOOOOOOOOOGOOOOOOOOOOOOOOOOOOOOOGOOOOOOOOOOOOOOOOOOOOOGOOOOOOOOOOOOOOOOOOOOOGOOOOOOOOOOOOOOOOOOOOOGOOOOOOOOOOOOOOOOOOOOOGOOOOOOOOOOOOOOOOOOOOOGOOOOOOOOOOOOOOOOOOOOOGOOOOOOOOOOOOOOOOOOOOOGOOOOOOOOOOOOOOOOOOOOOGOOOOOOOOOOOOOOOOOOOOOGOOOOOOOOOOOOOOOOOAOOO,0,0,0
10017,286,1,285,143,171,0,0,456,383,73,GOOOOOOOOOOOOOOOOOOOOOGOOOOOOOOOOOOOOOOOOOOOGOOOOOOOOOOOOOOOOOOOOOGOOOOOOOOOOOOOOOOOOOOOGOOOOOOOOOOOOOOOOOOOOOGOOOOOOOOOOOOOOOOOOOOOGOOOOOOOOOOOOOOOOOOOOOGOOOOOOOOOOOOOOOOOOOOOGOOOOOOOOOOOOOOOOOOOOOGOOOOOOOOOOOOOOOOOOOOOGOOOOOOOOOOOOOOOOOOOOOGOOOOOOOOOOOOOOOOOOOOOGOOOOOOOOOOOOOOOOOAOOO,600,0,0
10038,286,1,285,147,167,0,0,453,382,71,GOOOOOOOOOOOOOOOOOOOOOGOOOOOOOOOOOOOOOOOOOOOGOOOOOOOOOOOOOOOOOOOOOGOOOOOOOOOOOOOOOOOOOOOGOOOOOOOOOOOOOOOOOOOOOGOOOOOOOOOOOOOOOOOOOOOGOOOOOOOOOOOOOOOOOOOOOGOOOOOOOOOOOOOOOOOOOOOGOOOOOOOOOOOOOOOOOOOOOGOOOOOOOOOOOOOOOOOOOOOGOOOOOOOOOOOOOOOOOOOOOGOOOOOOOOOOOOOOOOOOOOOGOOOOOOOOOOOOOOOOOAOOO,600,0,0
10059,286,1,285,149,165,0,0,451,383,68,GOOOOOOOOOOOOOOOOOOOOOGOOOOOOOOOOOOOOOOOOOOOGOOOOOOOOOOOOOOOOOOOOOGOOOOOOOOOOOOOOOOOOOOOGOOOOOOOOOOOOOOOOOOOOOGOOOOOOOOOOOOOOOOOOOOOGOOOOOOOOOOOOOOOOOOOOOGOOOOOOOOOOOOOOOOOOOOOGOOOOOOOOOOOOOOOOOOOOOGOOOOOOOOOOOOOOOOOOOOOGOOOOOOOOOOOOOOOOOOOOOGOOOOOOOOOOOOOOOOOOOOOGOOOOOOOOOOOOOOOOOAOOO,600,0,0

10080,286,1,285,147,167,0,0,453,385,68,GOOOOOOOOOOOOOOOOOOOOOGOOOOOOOOOOOOOOOOOOOOOGOOOOOOOOOOOOOOOOOOOOOGOOOOOOOOOOOOOOOOOOOOOGOOOOOOOOOOOOOOOOOOOOOGOOOOOOOOOOOOOOOOOOOOOGOOOOOOOOOOOOOOOOOOOOOGOOOOOOOOOOOOOOOOOOOOOGOOOOOOOOOOOOOOOOOOOOOGOOOOOOOOOOOOOOOOOOOOOGOOOOOOOOOOOOOOOOOOOOOGOOOOOOOOOOOOOOOOOOOOOGOOOOOOOOOOOOOOOOOAOOO,600,0,0
10101,286,1,285,148,166,0,0,452,386,66,GOOOOOOOOOOOOOOOOOOOOOGOOOOOOOOOOOOOOOOOOOOOGOOOOOOOOOOOOOOOOOOOOOGOOOOOOOOOOOOOOOOOOOOOGOOOOOOOOOOOOOOOOOOOOOGOOOOOOOOOOOOOOOOOOOOOGOOOOOOOOOOOOOOOOOOOOOGOOOOOOOOOOOOOOOOOOOOOGOOOOOOOOOOOOOOOOOOOOOGOOOOOOOOOOOOOOOOOOOOOGOOOOOOOOOOOOOOOOOOOOOGOOOOOOOOOOOOOOOOOOOOOGOOOOOOOOOOOOOOOOOAOOO,600,0,0
10122,286,1,285,146,168,0,0,453,388,65,GOOOOOOOOOOOOOOOOOOOOOGOOOOOOOOOOOOOOOOOOOOOGOOOOOOOOOOOOOOOOOOOOOGOOOOOOOOOOOOOOOOOOOOOGOOOOOOOOOOOOOOOOOOOOOGOOOOOOOOOOOOOOOOOOOOOGOOOOOOOOOOOOOOOOOOOOOGOOOOOOOOOOOOOOOOOOOOOGOOOOOOOOOOOOOOOOOOOOOGOOOOOOOOOOOOOOOOOOOOOGOOOOOOOOOOOOOOOOOOOOOGOOOOOOOOOOOOOOOOOOOOOGOOOOOOOOOOOOOOOOOAOOO,600,0,0
10143,286,1,285,145,169,0,0,454,391,63,GOOOOOOOOOOOOOOOOOOOOOGOOOOOOOOOOOOOOOOOOOOOGOOOOOOOOOOOOOOOOOOOOOGOOOOOOOOOOOOOOOOOOOOOGOOOOOOOOOOOOOOOOOOOOOGOOOOOOOOOOOOOOOOOOOOOGOOOOOOOOOOOOOOOOOOOOOGOOOOOOOOOOOOOOOOOOOOOGOOOOOOOOOOOOOOOOOOOOOGOOOOOOOOOOOOOOOOOOOOOGOOOOOOOOOOOOOOOOOOOOOGOOOOOOOOOOOOOOOOOOOOOGOOOOOOOOOOOOOOOOOAOOO,600,0,0
10164,286,1,285,147,167,0,0,453,393,60,GOOOOOOOOOOOOOOOOOOOOOGOOOOOOOOOOOOOOOOOOOOOGOOOOOOOOOOOOOOOOOOOOOGOOOOOOOOOOOOOOOOOOOOOGOOOOOOOOOOOOOOOOOOOOOGOOOOOOOOOOOOOOOOOOOOOGOOOOOOOOOOOOOOOOOOOOOGOOOOOOOOOOOOOOOOOOOOOGOOOOOOOOOOOOOOOOOOOOOGOOOOOOOOOOOOOOOOOOOOOGOOOOOOOOOOOOOOOOOOOOOGOOOOOOOOOOOOOOOOOOOOOGOOOOOOOOOOOOOOOOOAOOO,600,0,0

10185,286,1,285,143,171,0,0,457,395,62,GOOOOOOOOOOOOOOOOOOOOOGOOOOOOOOOOOOOOOOOOOOOGOOOOOOOOOOOOOOOOOOOOOGOOOOOOOOOOOOOOOOOOOOOGOOOOOOOOOOOOOOOOOOOOOGOOOOOOOOOOOOOOOOOOOOOGOOOOOOOOOOOOOOOOOOOOOGOOOOOOOOOOOOOOOOOOOOOGOOOOOOOOOOOOOOOOOOOOOGOOOOOOOOOOOOOOOOOOOOOGOOOOOOOOOOOOOOOOOOOOOGOOOOOOOOOOOOOOOOOOOOOGOOOOOOOOOOOOOOOOOAOOO,600,0,0
10206,286,1,285,139,175,0,0,460,395,65,GOOOOOOOOOOOOOOOOOOOOOGOOOOOOOOOOOOOOOOOOOOOGOOOOOOOOOOOOOOOOOOOOOGOOOOOOOOOOOOOOOOOOOOOGOOOOOOOOOOOOOOOOOOOOOGOOOOOOOOOOOOOOOOOOOOOGOOOOOOOOOOOOOOOOOOOOOGOOOOOOOOOOOOOOOOOOOOOGOOOOOOOOOOOOOOOOOOOOOGOOOOOOOOOOOOOOOOOOOOOGOOOOOOOOOOOOOOOOOOOOOGOOOOOOOOOOOOOOOOOOOOOGOOOOOOOOOOOOOOOOOAOOO,600,0,0
10227,286,1,285,142,172,0,0,458,396,62,GOOOOOOOOOOOOOOOOOOOOOGOOOOOOOOOOOOOOOOOOOOOGOOOOOOOOOOOOOOOOOOOOOGOOOOOOOOOOOOOOOOOOOOOGOOOOOOOOOOOOOOOOOOOOOGOOOOOOOOOOOOOOOOOOOOOGOOOOOOOOOOOOOOOOOOOOOGOOOOOOOOOOOOOOOOOOOOOGOOOOOOOOOOOOOOOOOOOOOGOOOOOOOOOOOOOOOOOOOOOGOOOOOOOOOOOOOOOOOOOOOGOOOOOOOOOOOOOOOOOOOOOGOOOOOOOOOOOOOOOOOAOOO,600,0,0
10248,286,1,285,146,168,0,0,454,393,61,GOOOOOOOOOOOOOOOOOOOOOGOOOOOOOOOOOOOOOOOOOOOGOOOOOOOOOOOOOOOOOOOOOGOOOOOOOOOOOOOOOOOOOOOGOOOOOOOOOOOOOOOOOOOOOGOOOOOOOOOOOOOOOOOOOOOGOOOOOOOOOOOOOOOOOOOOOGOOOOOOOOOOOOOOOOOOOOOGOOOOOOOOOOOOOOOOOOOOOGOOOOOOOOOOOOOOOOOOOOOGOOOOOOOOOOOOOOOOOOOOOGOOOOOOOOOOOOOOOOOOOOOGOOOOOOOOOOOOOOOOOAOOO,600,0,0
10269,286,1,285,147,167,0,0,453,392,61,GOOOOOOOOOOOOOOOOOOOOOGOOOOOOOOOOOOOOOOOOOOOGOOOOOOOOOOOOOOOOOOOOOGOOOOOOOOOOOOOOOOOOOOOGOOOOOOOOOOOOOOOOOOOOOGOOOOOOOOOOOOOOOOOOOOOGOOOOOOOOOOOOOOOOOOOOOGOOOOOOOOOOOOOOOOOOOOOGOOOOOOOOOOOOOOOOOOOOOGOOOOOOOOOOOOOOOOOOOOOGOOOOOOOOOOOOOOOOOOOOOGOOOOOOOOOOOOOOOOOOOOOGOOOOOOOOOOOOOOOOOAOOO,600,0,0

10290,286,1,285,146,168,0,0,454,392,62,GOOOOOOOOOOOOOOOOOOOOOGOOOOOOOOOOOOOOOOOOOOOGOOOOOOOOOOOOOOOOOOOOOGOOOOOOOOOOOOOOOOOOOOOGOOOOOOOOOOOOOOOOOOOOOGOOOOOOOOOOOOOOOOOOOOOGOOOOOOOOOOOOOOOOOOOOOGOOOOOOOOOOOOOOOOOOOOOGOOOOOOOOOOOOOOOOOOOOOGOOOOOOOOOOOOOOOOOOOOOGOOOOOOOOOOOOOOOOOOOOOGOOOOOOOOOOOOOOOOOOOOOGOOOOOOOOOOOOOOOOOAOOO,600,0,0
10311,286,0,286,150,164,0,0,450,391,59,GOOOOOOOOOOOOOOOOOOOOOGOOOOOOOOOOOOOOOOOOOOOGOOOOOOOOOOOOOOOOOOOOOGOOOOOOOOOOOOOOOOOOOOOGOOOOOOOOOOOOOOOOOOOOOGOOOOOOOOOOOOOOOOOOOOOGOOOOOOOOOOOOOOOOOOOOOGOOOOOOOOOOOOOOOOOOOOOGOOOOOOOOOOOOOOOOOOOOOGOOOOOOOOOOOOOOOOOOOOOGOOOOOOOOOOOOOOOOOOOOOGOOOOOOOOOOOOOOOOOOOOOGOOOOOOOOOOOOOOOOOOOOO,600,0,0
10332,286,0,286,148,166,0,0,453,394,59,GOOOOOOOOOOOOOOOOOOOOOGOOOOOOOOOOOOOOOOOOOOOGOOOOOOOOOOOOOOOOOOOOOGOOOOOOOOOOOOOOOOOOOOOGOOOOOOOOOOOOOOOOOOOOOGOOOOOOOOOOOOOOOOOOOOOGOOOOOOOOOOOOOOOOOOOOOGOOOOOOOOOOOOOOOOOOOOOGOOOOOOOOOOOOOOOOOOOOOGOOOOOOOOOOOOOOOOOOOOOGOOOOOOOOOOOOOOOOOOOOOGOOOOOOOOOOOOOOOOOOOOOGOOOOOOOOOOOOOOOOOOOOO,600,0,0
10353,286,0,286,144,170,0,0,457,397,60,GOOOOOOOOOOOOOOOOOOOOOGOOOOOOOOOOOOOOOOOOOOOGOOOOOOOOOOOOOOOOOOOOOGOOOOOOOOOOOOOOOOOOOOOGOOOOOOOOOOOOOOOOOOOOOGOOOOOOOOOOOOOOOOOOOOOGOOOOOOOOOOOOOOOOOOOOOGOOOOOOOOOOOOOOOOOOOOOGOOOOOOOOOOOOOOOOOOOOOGOOOOOOOOOOOOOOOOOOOOOGOOOOOOOOOOOOOOOOOOOOOGOOOOOOOOOOOOOOOOOOOOOGOOOOOOOOOOOOOOOOOOOOO,600,0,0
10374,286,0,286,146,168,0,0,455,396,59,GOOOOOOOOOOOOOOOOOOOOOGOOOOOOOOOOOOOOOOOOOOOGOOOOOOOOOOOOOOOOOOOOOGOOOOOOOOOOOOOOOOOOOOOGOOOOOOOOOOOOOOOOOOOOOGOOOOOOOOOOOOOOOOOOOOOGOOOOOOOOOOOOOOOOOOOOOGOOOOOOOOOOOOOOOOOOOOOGOOOOOOOOOOOOOOOOOOOOOGOOOOOOOOOOOOOOOOOOOOOGOOOOOOOOOOOOOOOOOOOOOGOOOOOOOOOOOOOOOOOOOOOGOOOOOOOOOOOOOOOOOOOOO,600,0,0

10395,286,0,286,148,166,0,0,452,393,59,GOOOOOOOOOOOOOOOOOOOOOGOOOOOOOOOOOOOOOOOOOOOGOOOOOOOOOOOOOOOOOOOOOGOOOOOOOOOOOOOOOOOOOOOGOOOOOOOOOOOOOOOOOOOOOGOOOOOOOOOOOOOOOOOOOOOGOOOOOOOOOOOOOOOOOOOOOGOOOOOOOOOOOOOOOOOOOOOGOOOOOOOOOOOOOOOOOOOOOGOOOOOOOOOOOOOOOOOOOOOGOOOOOOOOOOOOOOOOOOOOOGOOOOOOOOOOOOOOOOOOOOOGOOOOOOOOOOOOOOOOOOOOO,600,0,0
10416,286,0,286,145,169,0,0,455,391,64,GOOOOOOOOOOOOOOOOOOOOOGOOOOOOOOOOOOOOOOOOOOOGOOOOOOOOOOOOOOOOOOOOOGOOOOOOOOOOOOOOOOOOOOOGOOOOOOOOOOOOOOOOOOOOOGOOOOOOOOOOOOOOOOOOOOOGOOOOOOOOOOOOOOOOOOOOOGOOOOOOOOOOOOOOOOOOOOOGOOOOOOOOOOOOOOOOOOOOOGOOOOOOOOOOOOOOOOOOOOOGOOOOOOOOOOOOOOOOOOOOOGOOOOOOOOOOOOOOOOOOOOOGOOOOOOOOOOOOOOOOOOOOO,600,0,0
10437,286,0,286,146,168,0,0,454,393,61,GOOOOOOOOOOOOOOOOOOOOOGOOOOOOOOOOOOOOOOOOOOOGOOOOOOOOOOOOOOOOOOOOOGOOOOOOOOOOOOOOOOOOOOOGOOOOOOOOOOOOOOOOOOOOOGOOOOOOOOOOOOOOOOOOOOOGOOOOOOOOOOOOOOOOOOOOOGOOOOOOOOOOOOOOOOOOOOOGOOOOOOOOOOOOOOOOOOOOOGOOOOOOOOOOOOOOOOOOOOOGOOOOOOOOOOOOOOOOOOOOOGOOOOOOOOOOOOOOOOOOOOOGOOOOOOOOOOOOOOOOOOOOO,600,0,0
10458,286,0,286,143,171,0,0,456,395,61,GOOOOOOOOOOOOOOOOOOOOOGOOOOOOOOOOOOOOOOOOOOOGOOOOOOOOOOOOOOOOOOOOOGOOOOOOOOOOOOOOOOOOOOOGOOOOOOOOOOOOOOOOOOOOOGOOOOOOOOOOOOOOOOOOOOOGOOOOOOOOOOOOOOOOOOOOOGOOOOOOOOOOOOOOOOOOOOOGOOOOOOOOOOOOOOOOOOOOOGOOOOOOOOOOOOOOOOOOOOOGOOOOOOOOOOOOOOOOOOOOOGOOOOOOOOOOOOOOOOOOOOOGOOOOOOOOOOOOOOOOOOOOO,600,0,0
10479,286,0,286,143,171,0,0,457,394,63,GOOOOOOOOOOOOOOOOOOOOOGOOOOOOOOOOOOOOOOOOOOOGOOOOOOOOOOOOOOOOOOOOOGOOOOOOOOOOOOOOOOOOOOOGOOOOOOOOOOOOOOOOOOOOOGOOOOOOOOOOOOOOOOOOOOOGOOOOOOOOOOOOOOOOOOOOOGOOOOOOOOOOOOOOOOOOOOOGOOOOOOOOOOOOOOOOOOOOOGOOOOOOOOOOOOOOOOOOOOOGOOOOOOOOOOOOOOOOOOOOOGOOOOOOOOOOOOOOOOOOOOOGOOOOOOOOOOOOOOOOOOOOO,600,0,0

10500,286,0,286,141,173,0,0,459,397,62,GOOOOOOOOOOOOOOOOOOOOOGOOOOOOOOOOOOOOOOOOOOOGOOOOOOOOOOOOOOOOOOOOOGOOOOOOOOOOOOOOOOOOOOOGOOOOOOOOOOOOOOOOOOOOOGOOOOOOOOOOOOOOOOOOOOOGOOOOOOOOOOOOOOOOOOOOOGOOOOOOOOOOOOOOOOOOOOOGOOOOOOOOOOOOOOOOOOOOOGOOOOOOOOOOOOOOOOOOOOOGOOOOOOOOOOOOOOOOOOOOOGOOOOOOOOOOOOOOOOOOOOOGOOOOOOOOOOOOOOOOOOOOO,600,0,0
10521,284,0,284,143,171,0,0,457,401,56,GOOOOOOOOOOOOOOOOOOOOOGOOOOOOOOOOOOOOOOOOOOOGOOOOOOOOOOOOOOOOOOOOOGOOOOOOOOOOOOOOOOOOOOOGOOOOOOOOOOOOOOOOOOOOOGOOOOOOOOOOOOOOOOOOOOOGOOOOOOOOOOOOOOOOOOOOOGOOOOOOOOOOOOOOOOOOOOOGOOOOOOOOOOOOOOOOOOOOOGOOOOOOOOOOOOOOOOOOOOOGOOXOOOOOOOOOOOOOOOOOOGOOOOOOOOOOOOOXOOOOOOOGOOOOOOOOOOOOOOOOOOOOO,571,27,2
10542,282,0,282,143,171,0,0,457,401,56,GOOOOOOOOOOOOOOOOOOOOOGOOOOOOOOOOOOOOOOOOOOOGOOOOOOXOOOOOOOOOOOOOOGOOOOOOOOOOOOOOOOOOOOOGOOOOOOOOOOOOOOOOOOOOOGOOOOOOOOOOOOOOOOOOOOOGOOOOOOOOOOOOOOOOOOOOOGOOOOOOOOOOOOXOOOOOOOOGOOOOOOOOOOOOOOOOOOOOOGOOOOOOOOOOOOOOOOOOOOOGOOXOOOOOOOOOOOOOOOOOOGOOOOOOOOOOOOOXOOOOOOOGOOOOOOOOOOOOOOOOOOOOO,551,45,4
10563,281,1,280,141,172,0,0,458,401,57,GOOOOOOOOOOOOOOOOOOOOOGOOOOOOOOOOOOOOOOOOOOOGOOOOOOXXOOOOOOOOOOOOOGOOOOOOOOOOOOOOOOOOOOOGOOOOOOOOOOOOOOOOOOOOOGOOOOOOOOOOOOOOOOOOOOOGOOOOOOOOOOOOOOOOOOOOOGOOOOOOOOAOOOXOOOOOOOOGOOOOOOOOOOOOOOOOOOOOOGOOOOOOOOOOOOOOOOOOOOOGOOXOOOOOOOOOOOOOOOOOOGOOOOOOOOOOOOOXOOOOOOOGOOOOOOOOOOOOOOOOOOOOO,526,68,6
10584,280,2,278,138,174,0,0,460,406,54,GOOOOOOOOOOOOOOOOOOOOOGOOOOOOOOOOOOOOOOOOOOOGOOOOOOXXOOOOOOOOOOOOOGOOOOOOOOOOOOOOOOOOOOOGOOOOOOOOOOOOOOOOOOOOOGOOOOOOOOOOOOOOOOOOOOOGOOOOOOOOOOOOOOOOOOOOOGOOOOOOOOAOOOXOOOOOOOOGOOOOOOOAOOOOOOOOOOOOOGOOOOOOOOOOOOOOOOOOOOOGOOXOOOOOOOOOOOOOOOOOOGOOOXOOOOOOOOOXOOOOOOOGOOOOOOOOOOOOOOOOOOOOO,501,91,8

10605,278,2,276,137,175,0,0,461,406,55,GOOOOOOOOOOOOOOOOOOOOOGOOOOOOOOOOOOOOOOOOOOOGOOOOOOXXOOOOOOOOOOOOOGOOOOOOOOOOOOOOOOOOOOOGOOOOOOOOOOOOOOOOOOOOOGOOOOOOOOOOOOOOOOOOOOOGOOOOOOOOOOOOOOOOOOOOOGOOOOOOOOAOOOXOOOOOOOOGOOOOOOOAOOOOOOOOOOOOOGOOOOOOOOOOOOOOOOOOOOOGOOXOOOXOXOOOOOOOOOOOOGOOOXOOOOOOOOOXOOOOOOOGOOOOOOOOOOOOOOOOOOOOO,475,115,10
10626,278,5,273,132,177,0,0,462,406,56,GOOOOOOOOOOOOOOOOOOOOOGOOOOOOOOOOOOOOOOOOOOOGOOOOOOXXOOOOOOOOOOOOOGOOOXOOOOOOOOOOOOOOOOOGOOOOOOOOOOOOOOOOOOOOOGOOOOOOOOOOAOOOOOOOOOOGOOOOOOOOOOOOOOOOOOOOOGOOOAOOOOAOOOXOOOOOOOOGOOOOOOOAOOOOOOOOOOOOOGOOOOOOOOOOOOOOOOOOOOOGOOXOOOAOXOOOOOOOOOOOOGOOOXOOOOOOOOOXOOOOOOOGOOOOOOOOOOOOOOOOOOOOO,449,138,13
10647,277,5,272,133,176,0,0,461,404,57,GOOOOOOOOOOOOOOOOOOOOOGOOOOOOOOOOOOOOOOOOOOOGOOOOOOXXOOOOOOOOOOOOOGOOOXOOOOOOOOOOOOOOOOOGOOOOOOOOOOOOOOOOOOOOOGOOOOOOOOOOAOOOOOOOOOOGOOOOOOOOOOOOOOOOOOOOOGOOOAOOOOAOOOXOOOOOOOOGOOOOOOOAOOXOOOOOOOOOOGOOOOOOOOOOOOOOOOOOOOOGOOXOOOAOXOOOOOOOOOOOOGOOOXOOOOOOOOOXOOOOOOOGOOOOOOOOOOOOOOOOOOOOO,435,151,14
10668,277,4,273,131,178,0,0,465,403,62,GOOOOOOOOOOOOOOOOOOOOOGOOOOOOOOOOOOOOOOOOOOOGOOOOOOXXOOOOOOOOOOOOOGOOOXOOOOOOOOOOOOOOOOOGOOOOOOOOOOOOOOOOOOOOOGOOOOOOOOOOAOOOOOOOOOOGOOOOOOOOOOOOOOOOOOOOOGOOOAOOOOAOOOXOOOOOOOOGOOOOOOOOOOXOOOOOOOOOOGOOOOOOOOOOOOOOOOOOOOOGOOXOOOAOXOOOOOOOOOOOOGOOOXOOOOOOOOOXOOOOOOOGOOOOOOOOOOOOOOOOOOOOO,404,182,14
10689,277,4,273,136,173,0,0,460,399,61,GOOOOOOOOOOOOOOOOOOOOOGOOOOOOOOOOOOOOOOOOOOOGOOOOOOXXOOOOOOOOOOOOOGOOOXOOOOOOOOOOOOOOOOOGOOOOOOOOOOOOOOOOOOOOOGOOOOOOOOOOAOOOOOOOOOOGOOOOOOOOOOOOOOOOOOOOOGOOOAOOOOAOOOXOOOOOOOOGOOOOOOOOOOXOOOOOOOOOOGOOOOOOOOOOOOOOOOOOOOOGOOXOOOAOXOOOOOOOOOOOOGOOOXOOOOOOOOOXOOOOOOOGOOOOOOOOOOOOOOOOOOOOO,387,199,14

10710,279,7,272,135,171,0,0,459,400,59,GOOOOOOOOOOOOOOOOOOOOOGOOOOOOOOOOOOOOOOOOOOOGOOOOOOXXOOOOOOOOOOOOOGOOOAOOOOOOOOOOOOOOOOOGOOOOOOOOOOOOOOOOOOOOOGOOOOOOOOOOAOOOOOOOOOOGOOOOOOOOOOOOOOOOOOOOOGOOOAOOOOAOOOXOOOOOOOOGOOOOOOOOOOXOOOOOOOOOOGOOOOOOOOOOOOOOOOOOOOOGOOXOOOAOXOOOOOOOOOOOOGOOOXOOOOOOOOOAOOOOOOOGOOOOOOOOAOOOOOOOOOOOO,358,227,15
10731,279,8,271,133,172,0,0,460,401,59,GOOOOOOOOOOOOOOOOOOOOOGOOOOOOOOOOOOOOOOOOOOOGOOOOOOXXOOOOOOOOOOOOOGOOOAOOOOAOOOOOOOOOOOOGOOOOOOOOOOOOOOOOOOOOOGOOOOOOOOOOAOOOOOOOOOOGOOOOOOOOOOOOOOOOOOOOOGOOOAOOOOAOOOXOOOOOOOOGOOOOOOOOOOXOOOOOOOOOOGOOOOOOOOOOOOOOOOOOOOOGOOXOOOAOXOOOOOOOOOOOOGOOOXOOOOOOOOOAOOOOOOOGOOOOOOOOAOOOOOOOOOOOO,329,255,16
10752,278,7,271,134,171,0,0,460,401,59,GOOOOOOOOOOOOOOOOOOOOOGOOOOOOOOOOOOOOOOOOOOOGOOOOOOXXOOOOOOOOOOOOOGOOOAOOOOAOOOOOOOOOOOOGOOOOOOOOOOOOOOOOOOOOOGOOOOOOOOOOAOOOOOOOOOOGOOOOOOOOOOOOOOOOOOOOOGOOOAOOOOAOOOXOOOOOOOOGOOOOOOOOOOXOOOOOOOOOOGOOOOOOOOOOOOOOOOOOOOOGOOXOOOAOXOOOOOOOOOOOOGOOOXOOOOOOOOOOOOOOOOOGOOOOXOOOAOOOOOOOOOOOO,302,281,17
10773,274,7,267,135,170,0,0,459,406,53,GOOOOOOOOOOXOOOOOOOOOOGOOOOOOOOOOOOOOOOOOOOOGOOOOOOXXOOOOOOOOOOOOOGOOOAOOOOAOOOOOOOOOOOOGOOOOOOOOOOOOXOOOOOOOOGOOOOOOOOOXAOOOOOOOOOOGOOOOOOOOOOOOOOOOOOOOOGOOOAOOOOAOOOXOOOOOOOOGOOOOOOOOOOXOOOOOOOOOOGOOOOOOOOOOOOOOOOOOOOOGOOXOOOAOXOOOOOOOOOOOOGOOOXOOOOOOOOOOOOOOOOOGOOOOXOOOAOOXOOOOOOOOO,280,299,21
10794,271,6,265,135,170,0,0,460,408,52,GOOOOOOOOOOXOOOOOOOOOOGOOXOOOOOOOOOOOOOOOOOOGOOOOOOXXOOOOOOOOOOOOOGOOOAOOOOAOOOOOOOOOOOOGOOOOOOOOOOOOXOOOOOOOOGOXOOOOOOOXOOOOOOOOOOOGOOOOOOOOOOOOOOOOOOOOOGOOOAOOOOAOOOXOOOOOOOOGOOOOXOOOOOXOOOOOOOOOOGOOOOOOOOOOOOOOOOOOOOOGOOXOOOAOXOOOOOOOOOOOOGOOOXOOOOOOOOOOOOOOOOOGOOOOXOOOAOOXOOOOOOOOO,261,315,24

10815,269,9,260,136,166,0,0,456,407,49,GOOOOOOOOOOXOOOOOOOOOOGAOAOOOOOOOOOOOOOOOOOOGOOOOOOXXOOOOOXOOOOOOOGOOOAOOOOAOOOOOOOOOOOOGOOOOOOOOOOOOXOOOOOOOOGOXOOOOOOOXOOOOOOOOOOOGOOOOOOOOOOOOOOOOOOOOOGOOOAOOOOAOXOXOOOOOOOOGOXOOAOOOOOXOOOOOOOOOOGOOOOOOOOOOOOOOOOOOOOOGOOXOOXAOXOOOOOOOOOOOOGOOOXOOOOOOOOOOOOOOOOOGOOOOXOOOAOOXOOOOOOOOO,229,342,29
10836,267,9,258,138,164,0,0,454,402,52,GOOOXOOOOOOXOOOOOOOOOOGAOAOOOOOOOOOOOOOOOOOOGOOOOOOXXOOXOOXOOOOOOOGOOOAOOOOAOOOOOOOOOOOOGOOOOOOOOOOOOXOOOOOOOOGOXOOOOOOOXOOOOOOOOOOOGOOOOOOOOOOOOOOOOOOOOOGOOOAOOOOAOXOXOOOOOOOOGOXOOAOOOOOXOOOOOOOOOOGOOOOOOOOOOOOOOOOOOOOOGOOXOOXAOXOOOOOOOOOOOOGOOOXOOOOOOOOOOOOOOOOOGOOOOXOOOAOOXOOOOOOOOO,199,370,31
10857,266,10,256,133,167,0,0,458,403,55,GOOOXOOOOOOXOOOOOOOOOOGAOAOOOOOOOOOOOOOOOOOOGOOXOOOXXOOXOOXOOOOOOOGOXOAOOOXAOOOOOOOOOOOOGOOOOOOOOOOOOXOOOOOOOOGOAOOOOOOOXOOOOOOOOOOOGOOOOOOOOOOOOOOOOOOOOOGOOOAOOOOAOXOXOOOOOOOOGOOOOAOOOOOXOOOOOOOOOOGOOOOOOOOOOOOOOOOOOOOOGOOXOOXAOXOOOOOOOOOOOOGOOOXOOOOOOOOOOOOOOOOOGOOOOXOOOAOOXOOOOOOOOO,173,393,34
10878,261,10,251,132,168,0,0,459,407,52,GOOOXOOOOOOXOOOOOOOOOOGAOAOOXOOXOOOOOOOOOOOOGOOXOOOXXOOXOOXOOOOOOOGOXOAOOOXAOOOOOOOOOOOOGOOOOOOOOOOOOXOOOOOOOOGOAOOOOOOOXOOOOOOOOOOOGOOOOOOOOOOOOOOOOOOOOOGOOXAOOOOAOXOXOOOOOOOOGOOOOAOOOOOXOOOOOOOOOOGOOOOOOOXOOOOOOOOOOOOOGOOXOOXAOXOOOOOOOOOOOOGOOXXOOOOOOOOOOOOOOOOOGOOOOXOOOAOOXOOOOOOOOO,143,418,39
10899,260,11,249,131,168,0,0,459,405,54,GOOOXOOOOOOXOOOOOOOOOOGAOAOOXOOXOOOOOOOOOOOOGOOXOOOXXOOXOXXOOOOOOOGOXOAOOOXAOOOOOOOOOOOOGOOOOOOOOOOXOXOOOOOOOOGOAOOOOOOOXOOOOOOOOOOOGOOOOOOOOOOOOOOOOOOOOOGOOAAOOOOAOXOXOOOOOOOOGOOOOAOOOOOXOOOOOOOOOOGOOOOOOOXOOOOOOOOOOOOOGOOXOOXAOXOOOOOOOOOOOOGOOXXOOOOOOOOOOOOOOOOOGOOOOXOOOAOOXOOOOOOOOO,112,447,41

10920,260,11,249,133,166,0,0,457,404,53,GOOOXOOOOOOXOOOOOOOOOOGAOAOOXOOXOOOOOOOOOOOOGOOXOOOXXOOXOXXOOOOOOOGOXOAOOOXAOOOOOOOOOOOOGOOOOOOOOOOXOXOOOOOOOOGOAOOOOOOOXOOOOOOOOOOOGOOOOOOOOOOOOOOOOOOOOOGOOAAOOOOAOXOXOOOOOOOOGOOOOAOOOOOXOOOOOOOOOOGOOOOOOOXOOOOOOOOOOOOOGOOXOOXAOXOOOOOOOOOOOOGOOXXOOOOOOOOOOOOOOOOOGOOOOXOOOAOOXOOOOOOOOO,90,469,41
10941,259,10,249,132,167,0,0,458,406,52,GOOOXOOOOOOXOOOOOOOOOOGAOAOOXOOXOOOOOOOOOOOOGOOXOOOXXOOXOXXOOOOOOOGOXOAOOOXAOOOOOOOOOOOOGOOOOOOOOOOXOXOOOOOOOOGOAOOOOOOOXOOOOOOOOOOOGOOOOOOOOOOOOOOOOOOOOOGOOAAOOOOAOXOXOOOOOOOOGOOXOAOOOOOXOOOOOOOOOOGOOOOOOOXOOOOOOOOOOOOOGOOXOOXAOXOOOOOOOOOOOOGOOXXOOOOOOOOOOOOOOOOOGOOOOXOOOOOOXOOOOOOOOO,71,487,42
10962,255,10,245,132,167,0,0,459,404,55,GOOOXOOOOOOXOOOOOOOOOOGAOAOOXOOXOOOOOOOOOOOOGOOXOOOXXOOXOXXOOOOOOOGOXOAOOOXAOOOOOOOOOOOOGOXOOOOOOOOXOXOOOOOOOOGOAOOOOOOOXOOOOOOOOOOOGOOXOOOOOOOOOOOOOOOOOOGOOAAOOOOAOXOXOOOOOOOOGOOXOAOOOOOXOOXOOOOOOOGOOOOOOOXXOOOOOOOOOOOOGOOXOOXAOXOOOOOOOOOOOOGOOXXOOOOOOOOOOOOOOOOOGOOOOXOOOOOOXOOOOOOOOO,45,509,46
10983,257,12,245,127,169,0,0,462,406,56,GOOOXOOOOOOXOOOOOOOOOOGAOAOOXOOXOOOOOOOOOOOOGOOXOOOXXOOXOXXOOOOOOOGOXOAOOOXAOOOOOOOOOOOOGOXOOOOOOOOXOXOOOOOOOOGOAOOOOOOOXOOOOOOOOOOOGOOAOOOOOOOOOOOOOOOOOOGOOAAOOOOOOXOXOOOOOOOOGOOXOAOOOOOXOOXOOOOOOOGOOOOOOOXXOOOOOOOOOOOOGOOXOOXAOXOOOOOOOOOOOOGOOAXOOOOOOOOOOOOOOOAOGOOOOXOOOOOOXOOOOOOOOO,25,528,47
11004,252,11,241,124,171,0,0,466,409,57,GOOOXOOOOOOXOOOOOOOOOOGAOAOOXOOXOOOOOOOOOOOOGOOXXOOXXOOXOXXOOOOOOOGOXOAOOOXAOOOOOOOOOOOOGOXXOOOOOXOXOXOOOOOOOOGOAOOOOOOOXOOOOOOOOOOOGOOAOOOOOOOOOOOOOOOOOOGOOOAOOOOOOXOXOOOOOOOOGOOXOAOOOXOXOOXOOOOOOOGOOXOOOOXXOOOOOOOOOOOOGOOXOOXAOXOOOOOOOOOOOOGOOAXOOOOOOOOOOOOOOOOOGOOOOXOOOOOXAOOOOOOOOO,0,547,53

11025,250,11,239,123,172,0,0,467,409,58,GOOOXOOOOOOXOOOOOOOOOOGAOAOOXOOXOOXOOOOOOOOOGOOXXOOXXOOXOXXOOOOOOOGOXOAOOOXAOOOOOOOOOOOOGOXXOOOOOXOXOXOOOOOOOOGOAOOXOOOOXOOOOOOOOOOOGOOAOOOOOOOOOOOOOOOOOOGOOOAOOOOOOXOXOOOOOOOOGOOXOAOOOXOXOOXOOOOOOOGOOXOOOOXXOOOOOOOOOOOOGOOXOOXAOXOOOOOOOOOOOOGOOAXOOOOOOOOOOOOOOOOOGOOOOXOOOOOXAOOOOOOOOO,0,545,55
11046,246,11,235,124,171,0,0,466,411,55,GOOOXOOOOOOXOOOOOOOOOOGAOAOOXOOXOOXOOOOOOOOOGOOXXXOXXOOXOXXOOOOOOOGOXOAOOOXAOOOOOOOOOOOOGOXXOOOOOXOXOXXOOOOOOOGOAOOXOOOOXOOOOOOOOOOOGOOAOOOOOOOOOOOOOOOOOOGOOOAOOOOOOXOXOOOOOOOOGOOXOAOOOXOXOOXOOOXOOOGOOXOOOOXXOOOOOOOOOOOOGOOXOOXAOXOOOOOOOOOOOOGOOAXOOOOOOOXOOOOOOOOOGOOOOXOOOOOXAOOOOOOOOO,0,541,59
11067,246,11,235,128,166,0,0,461,408,53,GOOOXOOOOOOXOOOOOOOOOOGOOAOOXOOXOOXOOOOOOOOOGOOAXXOXXOOXOXXOOOOOOOGOXOAOOOXAOOOOOOOOOOOOGOXXOOOOOXOXOXXOOOOOOOGOAOOXOOOOXOOOOOOOOOOOGOOAOOOOOOOOOOOOOOOOOOGOOOAOOOOOOXOXOOOOOOOOGOOXOAOOOXOXOOXOOOXOOOGOOXOOOOXXOOOOOOOOOOOOGOOXOOXAOXOOOOOOOOOOOOGOOAXOOOOOOOXOOOOOOOOOGOOOOXOOOOOXAOOOOOXOOO,0,540,60
11088,241,12,229,129,165,0,0,460,408,52,GOOOXOXOOOOXOOOOOOOOOOGOOAOOXOOXOOXOOOOOOOOOGOOAXXOXXOOXOXXOOOOOOOGOXOAXOOXAOOOOOOOOOOOOGOXXXOOOOXOXOXXOOOOOOOGOAOOXOOOOXOOOOOOOXOOOGOOAOOOOOOOOOOOOOOOOOOGOOOAOOOOOOXOXOOOOOOOOGOOXOAOOOXOXOOAOOOXOOOGOOXOOOOXXOOOOOOOOOOOOGOOXOOXAXXOOOOOOOOOOOOGOOAXOOOXOOOXOOOOOOOOOGOOOOXOOOOOXAOOOOOXOOO,0,535,65
11109,47,4,43,129,357,0,0,468,404,64,GOOOXOXXXXXXXXXXXXXXXXGOOAOOXXXXXXXXXXXXXXXXGOOAXXXXXXXXXXXXXXXXXXGOXXXXXXXXXXXXXXXXXXXXGOXXXXXXXXXXXXXXXXXXXXGOAXXXXXXXXXXXXXXXXXXXGOOAXXXXXXXXXXXXXXXXXXGOXOXXXXXXXXXXXXXXXXXXGOOXXXXXXXXXXXXXXXXXXXGOOXXXXXXXXXXXXXXXXXXXGOOXXXXXXXXXXXXXXXXXXXGOOOXXXXXXXXXXXXXXXXXXGOOOOXXXXXXXXXXXXXXXXX,0,533,67

11130,48,6,42,141,344,0,0,454,392,62,GOOOXOXXXXXXXXXXXXXXXXGOOAOOAXXXXXXXXXXXXXXXGOOAXXXXXXXXXXXXXXXXXXGOXXXXXXXXXXXXXXXXXXXXGOXXXXXXXXXXXXXXXXXXXXGOAXXXXXXXXXXXXXXXXXXXGOOAXXXXXXXXXXXXXXXXXXGOXXXXXXXXXXXXXXXXXXXXGOOAXXXXXXXXXXXXXXXXXXGOOXXXXXXXXXXXXXXXXXXXGOOXXXXXXXXXXXXXXXXXXXGOOOXXXXXXXXXXXXXXXXXXGOOOOXXXXXXXXXXXXXXXXX,0,533,67
11151,49,7,42,144,340,0,0,450,394,56,GOOOXOXXXXXXXXXXXXXXXXGOOAOOAXXXXXXXXXXXXXXXGOOAXXXXXXXXXXXXXXXXXXGOXXXXXXXXXXXXXXXXXXXXGOAXXXXXXXXXXXXXXXXXXXGOAXXXXXXXXXXXXXXXXXXXGOOAXXXXXXXXXXXXXXXXXXGOXXXXXXXXXXXXXXXXXXXXGOOAXXXXXXXXXXXXXXXXXXGOOXXXXXXXXXXXXXXXXXXXGOOXXXXXXXXXXXXXXXXXXXGOOOXXXXXXXXXXXXXXXXXXGOOOOXXXXXXXXXXXXXXXXX,0,533,67
11172,51,8,43,145,337,0,0,448,389,59,GOOOXOXXXXXXXXXXXXXXXXGOOAOOAXXXXXXXXXXXXXXXGOOAXXXXXXXXXXXXXXXXXXGOAXXXXXXXXXXXXXXXXXXXGOAXXXXXXXXXXXXXXXXXXXGOAXXXXXXXXXXXXXXXXXXXGOOOXXXXXXXXXXXXXXXXXXGOAXXXXXXXXXXXXXXXXXXXGOOAXXXXXXXXXXXXXXXXXXGOOXXXXXXXXXXXXXXXXXXXGOOXXXXXXXXXXXXXXXXXXXGOOOXXXXXXXXXXXXXXXXXXGOOOOXXXXXXXXXXXXXXXXX,0,533,67
11193,51,8,43,148,334,0,0,443,385,58,GOOOXOXXXXXXXXXXXXXXXXGOOAOOAXXXXXXXXXXXXXXXGOOAXXXXXXXXXXXXXXXXXXGOAXXXXXXXXXXXXXXXXXXXGOAXXXXXXXXXXXXXXXXXXXGOAXXXXXXXXXXXXXXXXXXXGOOOXXXXXXXXXXXXXXXXXXGOAXXXXXXXXXXXXXXXXXXXGOOAXXXXXXXXXXXXXXXXXXGOOXXXXXXXXXXXXXXXXXXXGOOXXXXXXXXXXXXXXXXXXXGOOOXXXXXXXXXXXXXXXXXXGOOOOXXXXXXXXXXXXXXXXX,0,533,67
11214,51,7,44,147,335,0,0,447,385,62,GOOOXOXXXXXXXXXXXXXXXXGOOAOOAXXXXXXXXXXXXXXXGOOAXXXXXXXXXXXXXXXXXXGOAXXXXXXXXXXXXXXXXXXXGOAXXXXXXXXXXXXXXXXXXXGOAXXXXXXXXXXXXXXXXXXXGOOOXXXXXXXXXXXXXXXXXXGOOXXXXXXXXXXXXXXXXXXXGOOAXXXXXXXXXXXXXXXXXXGOOXXXXXXXXXXXXXXXXXXXGOOXXXXXXXXXXXXXXXXXXXGOOOXXXXXXXXXXXXXXXXXXGOOOOXXXXXXXXXXXXXXXXX,0,533,67

11235,51,7,44,148,333,0,0,446,382,64,GOOOXOXXXXXXXXXXXXXXXXGOOAOOOXXXXXXXXXXXXXXXGOOAXXXXXXXXXXXXXXXXXXGOAXXXXXXXXXXXXXXXXXXXGAAXXXXXXXXXXXXXXXXXXXGOAXXXXXXXXXXXXXXXXXXXGOOOXXXXXXXXXXXXXXXXXXGOOXXXXXXXXXXXXXXXXXXXGOOAXXXXXXXXXXXXXXXXXXGOOXXXXXXXXXXXXXXXXXXXGOOXXXXXXXXXXXXXXXXXXXGOOOXXXXXXXXXXXXXXXXXXGOOOOXXXXXXXXXXXXXXXXX,0,532,68
11256,53,9,44,150,329,0,0,442,378,64,GOOOXOXXXXXXXXXXXXXXXXGOOAOOOXXXXXXXXXXXXXXXGOOAXXXXXXXXXXXXXXXXXXGOAAAXXXXXXXXXXXXXXXXXGAAXXXXXXXXXXXXXXXXXXXGOAXXXXXXXXXXXXXXXXXXXGOOOXXXXXXXXXXXXXXXXXXGOOXXXXXXXXXXXXXXXXXXXGOOAXXXXXXXXXXXXXXXXXXGOOXXXXXXXXXXXXXXXXXXXGOOXXXXXXXXXXXXXXXXXXXGOOOXXXXXXXXXXXXXXXXXXGOOOOXXXXXXXXXXXXXXXXX,0,532,68
11277,53,9,44,153,326,0,0,439,373,66,GOOOXOXXXXXXXXXXXXXXXXGOOAOOOXXXXXXXXXXXXXXXGOOAXXXXXXXXXXXXXXXXXXGOAAAXXXXXXXXXXXXXXXXXGAAXXXXXXXXXXXXXXXXXXXGOAXXXXXXXXXXXXXXXXXXXGOOOXXXXXXXXXXXXXXXXXXGOOXXXXXXXXXXXXXXXXXXXGOOAXXXXXXXXXXXXXXXXXXGOOXXXXXXXXXXXXXXXXXXXGOOXXXXXXXXXXXXXXXXXXXGOOOXXXXXXXXXXXXXXXXXXGOOOOXXXXXXXXXXXXXXXXX,0,532,68
11298,57,13,44,154,321,0,0,433,371,62,GOOOXOXXXXXXXXXXXXXXXXGOOAOOOXXXXXXXXXXXXXXXGOOAXXXXXXXXXXXXXXXXXXGOAAAXXXXXXXXXXXXXXXXXGAAAXXXXXXXXXXXXXXXXXXGOAXXXXXXXXXXXXXXXXXXXGOOOXXXXXXXXXXXXXXXXXXGOOAXXXXXXXXXXXXXXXXXXGOOAXXXXXXXXXXXXXXXXXXGOOAXXXXXXXXXXXXXXXXXXGOOAXXXXXXXXXXXXXXXXXXGOOOXXXXXXXXXXXXXXXXXXGOOOOXXXXXXXXXXXXXXXXX,0,532,68
11319,57,13,44,154,321,0,0,434,372,62,GOOOXOXXXXXXXXXXXXXXXXGOOAOOOXXXXXXXXXXXXXXXGOOAXXXXXXXXXXXXXXXXXXGOAAAXXXXXXXXXXXXXXXXXGAAAXXXXXXXXXXXXXXXXXXGOAXXXXXXXXXXXXXXXXXXXGOOOXXXXXXXXXXXXXXXXXXGOOAXXXXXXXXXXXXXXXXXXGOOAXXXXXXXXXXXXXXXXXXGOOAXXXXXXXXXXXXXXXXXXGOOAXXXXXXXXXXXXXXXXXXGOOOXXXXXXXXXXXXXXXXXXGOOOOXXXXXXXXXXXXXXXXX,0,532,68

11340,59,14,45,154,319,0,0,433,371,62,GOOOAOXXXXXXXXXXXXXXXXGOOAOOOXXXXXXXXXXXXXXXGOOAXXXXXXXXXXXXXXXXXXGOAAAXXXXXXXXXXXXXXXXXGAAOXXXXXXXXXXXXXXXXXXGOAAXXXXXXXXXXXXXXXXXXGOOOXXXXXXXXXXXXXXXXXXGOOAXXXXXXXXXXXXXXXXXXGOOAXXXXXXXXXXXXXXXXXXGOOAXXXXXXXXXXXXXXXXXXGOOAXXXXXXXXXXXXXXXXXXGOOOXXXXXXXXXXXXXXXXXXGOOOOXXXXXXXXXXXXXXXXX,0,532,68
11361,59,14,45,158,315,0,0,429,367,62,GOOOAOXXXXXXXXXXXXXXXXGOOAOOOXXXXXXXXXXXXXXXGOOAXXXXXXXXXXXXXXXXXXGOAAAXXXXXXXXXXXXXXXXXGAAOXXXXXXXXXXXXXXXXXXGOAAXXXXXXXXXXXXXXXXXXGOOOXXXXXXXXXXXXXXXXXXGOOAXXXXXXXXXXXXXXXXXXGOOAXXXXXXXXXXXXXXXXXXGOOAXXXXXXXXXXXXXXXXXXGOOAXXXXXXXXXXXXXXXXXXGOOOXXXXXXXXXXXXXXXXXXGOOOOXXXXXXXXXXXXXXXXX,0,532,68
11382,60,14,46,164,308,0,0,423,362,61,GOOOAOXXXXXXXXXXXXXXXXGOOAOOOXXXXXXXXXXXXXXXGOOAXXXXXXXXXXXXXXXXXXGOOAAXXXXXXXXXXXXXXXXXGAAOXXXXXXXXXXXXXXXXXXGOAAXXXXXXXXXXXXXXXXXXGOOOXXXXXXXXXXXXXXXXXXGOOAXXXXXXXXXXXXXXXXXXGOOAXXXXXXXXXXXXXXXXXXGOOAXXXXXXXXXXXXXXXXXXGOOAXXXXXXXXXXXXXXXXXXGOOOXXXXXXXXXXXXXXXXXXGOOOOAXXXXXXXXXXXXXXXX,0,532,68
11403,61,15,46,164,307,0,0,421,360,61,GOOOAOXXXXXXXXXXXXXXXXGOOAOOOXXXXXXXXXXXXXXXGOOAXXXXXXXXXXXXXXXXXXGOOAAAXXXXXXXXXXXXXXXXGAAOXXXXXXXXXXXXXXXXXXGOAAXXXXXXXXXXXXXXXXXXGOOOXXXXXXXXXXXXXXXXXXGOOAXXXXXXXXXXXXXXXXXXGOOAXXXXXXXXXXXXXXXXXXGOOAXXXXXXXXXXXXXXXXXXGOOAXXXXXXXXXXXXXXXXXXGOOOXXXXXXXXXXXXXXXXXXGOOOOAXXXXXXXXXXXXXXXX,0,532,68
11424,60,15,45,165,306,0,0,420,358,62,GOOOAOXXXXXXXXXXXXXXXXGOOAOOOXXXXXXXXXXXXXXXGOOAXXXXXXXXXXXXXXXXXXGOOAAAXXXXXXXXXXXXXXXXGAAXXXXXXXXXXXXXXXXXXXGOAAXXXXXXXXXXXXXXXXXXGOOOXXXXXXXXXXXXXXXXXXGOOAXXXXXXXXXXXXXXXXXXGOOAXXXXXXXXXXXXXXXXXXGOOAXXXXXXXXXXXXXXXXXXGOOAXXXXXXXXXXXXXXXXXXGOOOXXXXXXXXXXXXXXXXXXGOOOOAXXXXXXXXXXXXXXXX,0,531,69

11445,67,22,45,162,302,0,0,415,351,64,GOOOAOXXXXXXXXXXXXXXXXGOOAOOOAXXXXXXXXXXXXXXGOOAXXXXXXXXXXXXXXXXXXGOOAAAXXXXXXXXXXXXXXXXGAAXXXXXXXXXXXXXXXXXXXGOAAXXXXXXXXXXXXXXXXXXGOOOXXXXXXXXXXXXXXXXXXGOOAXXXXXXXXXXXXXXXXXXGOOAXXXXXXXXXXXXXXXXXXGOOAXXXXXXXXXXXXXXXXXXGOOAXXXXXXXXXXXXXXXXXXGOOOXXXXXXXXXXXXXXXXXXGOOOOAAAAAAAXXXXXXXXXX,0,531,69
11466,69,25,44,167,294,0,0,408,348,60,GOOOAOAXXXXXXXXXXXXXXXGOOAOOOAXXXXXXXXXXXXXXGOOAXXXXXXXXXXXXXXXXXXGOOAAAXXXXXXXXXXXXXXXXGAAXXXXXXXXXXXXXXXXXXXGOAAXXXXXXXXXXXXXXXXXXGOOOXXXXXXXXXXXXXXXXXXGOOAAXXXXXXXXXXXXXXXXXGOXAXXXXXXXXXXXXXXXXXXGOOAXXXXXXXXXXXXXXXXXXGOOAXXXXXXXXXXXXXXXXXXGOOOXXXXXXXXXXXXXXXXXXGOOOOAAAAAAAAXXXXXXXXX,0,530,70
11487,70,26,44,168,292,0,0,406,344,62,GOOOAOAXXXXXXXXXXXXXXXGOOAOOOAXXXXXXXXXXXXXXGOOAXXXXXXXXXXXXXXXXXXGOOAAAXXXXXXXXXXXXXXXXGAAXXXXXXXXXXXXXXXXXXXGOAAXXXXXXXXXXXXXXXXXXGOOOXXXXXXXXXXXXXXXXXXGOOAAXXXXXXXXXXXXXXXXXGOAAXXXXXXXXXXXXXXXXXXGOOAXXXXXXXXXXXXXXXXXXGOOAXXXXXXXXXXXXXXXXXXGOOOXXXXXXXXXXXXXXXXXXGOOOOAAAAAAAAXXXXXXXXX,0,530,70
11508,71,27,44,165,293,0,0,408,345,63,GOOOAOAXXXXXXXXXXXXXXXGOOAOOOAXXXXXXXXXXXXXXGOOAXXXXXXXXXXXXXXXXXXGOOAAAXXXXXXXXXXXXXXXXGAAXXXXXXXXXXXXXXXXXXXGAAAXXXXXXXXXXXXXXXXXXGOOOXXXXXXXXXXXXXXXXXXGOOAAXXXXXXXXXXXXXXXXXGOOAXXXXXXXXXXXXXXXXXXGOOAXXXXXXXXXXXXXXXXXXGOOAXXXXXXXXXXXXXXXXXXGOOOAXXXXXXXXXXXXXXXXXGOOOOAAAAAAAAXXXXXXXXX,0,529,71
11529,72,28,44,163,293,0,0,409,340,69,GOOOAOAXXXXXXXXXXXXXXXGOOAOOXAXXXXXXXXXXXXXXGOOAXXXXXXXXXXXXXXXXXXGOOAAAXXXXXXXXXXXXXXXXGAAXXXXXXXXXXXXXXXXXXXGAAAXXXXXXXXXXXXXXXXXXGOOOXXXXXXXXXXXXXXXXXXGOOAAXXXXXXXXXXXXXXXXXGOOAXXXXXXXXXXXXXXXXXXGOOAXXXXXXXXXXXXXXXXXXGOOOXXXXXXXXXXXXXXXXXXGOOOAXXXXXXXXXXXXXXXXXGOOOOAAAAAAAAAAXXXXXXX,0,528,72

11550,74,29,45,162,292,0,0,409,337,72,GOOOAOAXXXXXXXXXXXXXXXGOOAOOXXXXXXXXXXXXXXXXGOOAXXXXXXXXXXXXXXXXXXGOOAAAXXXXXXXXXXXXXXXXGAAXXXXXXXXXXXXXXXXXXXGAAOXXXXXXXXXXXXXXXXXXGOOOXXXXXXXXXXXXXXXXXXGOOAAAAXXXXXXXXXXXXXXXGOOAXXXXXXXXXXXXXXXXXXGOOAXXXXXXXXXXXXXXXXXXGOOOXXXXXXXXXXXXXXXXXXGOOOAXXXXXXXXXXXXXXXXXGOOOOAAAAAAAAAAAXXXXXX,0,528,72
11571,75,30,45,160,293,0,0,410,338,72,GOOOAOAXXXXXXXXXXXXXXXGOOAOOXXXXXXXXXXXXXXXXGOOAXXXXXXXXXXXXXXXXXXGOOAAAXXXXXXXXXXXXXXXXGAAXXXXXXXXXXXXXXXXXXXGAAOXXXXXXXXXXXXXXXXXXGOOOXXXXXXXXXXXXXXXXXXGOOAAAAAXXXXXXXXXXXXXXGOOAXXXXXXXXXXXXXXXXXXGOOAXXXXXXXXXXXXXXXXXXGOOOXXXXXXXXXXXXXXXXXXGOOOAXXXXXXXXXXXXXXXXXGOOOOAAAAAAAAAAAXXXXXX,0,528,72
11592,77,30,47,158,293,0,0,412,337,75,GOOOOOAXXXXXXXXXXXXXXXGOOAOOXXXXXXXXXXXXXXXXGOOAXXXXXXXXXXXXXXXXXXGOOAAAXXXXXXXXXXXXXXXXGAAXXXXXXXXXXXXXXXXXXXGAAOXXXXXXXXXXXXXXXXXXGOOOXXXXXXXXXXXXXXXXXXGOOAAAAAXXXXXXXXXXXXXXGOOAXXXXXXXXXXXXXXXXXXGOOAXXXXXXXXXXXXXXXXXXGOOOXXXXXXXXXXXXXXXXXXGOOOAXXXXXXXXXXXXXXXXXGOOOOAAAAAAAOAAAAAXXXX,0,528,72
11613,77,31,46,159,291,0,0,410,333,77,GOOOXOAXXXXXXXXXXXXXXXGOOAOOXXXXXXXXXXXXXXXXGOOAXXXXXXXXXXXXXXXXXXGOOAAAXXXXXXXXXXXXXXXXGAAXXXXXXXXXXXXXXXXXXXGAAOXXXXXXXXXXXXXXXXXXGOOOXXXXXXXXXXXXXXXXXXGOOAAAAAXXXXXXXXXXXXXXGOOAXXXXXXXXXXXXXXXXXXGOOAXXXXXXXXXXXXXXXXXXGOOOXXXXXXXXXXXXXXXXXXGOOOAXXXXXXXXXXXXXXXXXGOOOOAAAAAAAOAAAAAAXXX,0,527,73
11634,77,32,45,159,289,0,0,409,330,79,GOOOXOAXXXXXXXXXXXXXXXGOOAOOXXXXXXXXXXXXXXXXGOOOXXXXXXXXXXXXXXXXXXGAOAAAXXXXXXXXXXXXXXXXGAAXXXXXXXXXXXXXXXXXXXGAAOXXXXXXXXXXXXXXXXXXGOOOXXXXXXXXXXXXXXXXXXGOOAAAAAXXXXXXXXXXXXXXGOOAXXXXXXXXXXXXXXXXXXGOOAXXXXXXXXXXXXXXXXXXGAOOXXXXXXXXXXXXXXXXXXGOOOAXXXXXXXXXXXXXXXXXGOOOOAAAAAAAOAAAAAAXXX,0,525,75

11655,76,32,44,164,284,0,0,403,326,77,GOOOXOAXXXXXXXXXXXXXXXGOOAOOXXXXXXXXXXXXXXXXGOXOXXXXXXXXXXXXXXXXXXGAOAAAXXXXXXXXXXXXXXXXGAAXXXXXXXXXXXXXXXXXXXGAAOXXXXXXXXXXXXXXXXXXGOOOXXXXXXXXXXXXXXXXXXGOOAAAAAXXXXXXXXXXXXXXGOOAXXXXXXXXXXXXXXXXXXGOOAXXXXXXXXXXXXXXXXXXGAOOXXXXXXXXXXXXXXXXXXGOOOAXXXXXXXXXXXXXXXXXGOOOOAAAAAAAOAAAAAAXXX,0,524,76
11676,77,32,45,164,283,0,0,404,327,77,GOOOXOAXXXXXXXXXXXXXXXGOOAOOAXXXXXXXXXXXXXXXGOXOXXXXXXXXXXXXXXXXXXGAOAAAXXXXXXXXXXXXXXXXGAOXXXXXXXXXXXXXXXXXXXGAAOXXXXXXXXXXXXXXXXXXGOOOXXXXXXXXXXXXXXXXXXGOOAAAAAXXXXXXXXXXXXXXGOOAXXXXXXXXXXXXXXXXXXGOOAXXXXXXXXXXXXXXXXXXGAOOXXXXXXXXXXXXXXXXXXGOOOAXXXXXXXXXXXXXXXXXGOOOOAAAAAAAOAAAAAAXXX,0,524,76
11697,78,33,45,162,284,0,0,404,328,76,GOOOXOAXXXXXXXXXXXXXXXGOOAOOAXXXXXXXXXXXXXXXGOXOXXXXXXXXXXXXXXXXXXGAOAAAXXXXXXXXXXXXXXXXGAOXXXXXXXXXXXXXXXXXXXGAAOXXXXXXXXXXXXXXXXXXGOOOXXXXXXXXXXXXXXXXXXGOOAAAAAXXXXXXXXXXXXXXGOOAXXXXXXXXXXXXXXXXXXGOOAAXXXXXXXXXXXXXXXXXGAOOXXXXXXXXXXXXXXXXXXGOOOAXXXXXXXXXXXXXXXXXGOOOOAAAAAAAOAAAAAAXXX,0,524,76
11718,78,32,46,166,280,0,0,402,329,73,GOOOXOOXXXXXXXXXXXXXXXGOOAOOAXXXXXXXXXXXXXXXGOXOXXXXXXXXXXXXXXXXXXGAOAAAXXXXXXXXXXXXXXXXGAOXXXXXXXXXXXXXXXXXXXGAAOXXXXXXXXXXXXXXXXXXGOOOXXXXXXXXXXXXXXXXXXGOOAAAAAXXXXXXXXXXXXXXGOOAXXXXXXXXXXXXXXXXXXGOOAAXXXXXXXXXXXXXXXXXGAOOXXXXXXXXXXXXXXXXXXGOOOAXXXXXXXXXXXXXXXXXGOOOOAAAAAAAOAAAAAAXXX,0,524,76
11739,80,34,46,164,279,0,0,401,323,78,GOOOAOOXXXXXXXXXXXXXXXGOOAXOAXXXXXXXXXXXXXXXGOAOXXXXXXXXXXXXXXXXXXGAOAAAXXXXXXXXXXXXXXXXGAOAXXXXXXXXXXXXXXXXXXGAAOXXXXXXXXXXXXXXXXXXGOOOXXXXXXXXXXXXXXXXXXGOOAAAAAXXXXXXXXXXXXXXGOOAXXXXXXXXXXXXXXXXXXGOOAAXXXXXXXXXXXXXXXXXGAOOXXXXXXXXXXXXXXXXXXGOOOAXXXXXXXXXXXXXXXXXGOOOOAAAAAOAOAAAAAAXXX,0,523,77

11760,80,33,47,166,277,0,0,401,324,77,GOOOAOOXXXXXXXXXXXXXXXGOOAXOAXXXXXXXXXXXXXXXGOAOXXXXXXXXXXXXXXXXXXGAOAAAXXXXXXXXXXXXXXXXGAOAXXXXXXXXXXXXXXXXXXGOAOXXXXXXXXXXXXXXXXXXGOOOXXXXXXXXXXXXXXXXXXGOOAAAAAXXXXXXXXXXXXXXGOOAXXXXXXXXXXXXXXXXXXGOOAAXXXXXXXXXXXXXXXXXGAOOXXXXXXXXXXXXXXXXXXGOOOAXXXXXXXXXXXXXXXXXGOOOOAAAAAOAOAAAAAAXXX,0,523,77
11781,81,33,48,168,274,0,0,399,321,78,GOOOAOOXXXXXXXXXXXXXXXGOOAXOAAXXXXXXXXXXXXXXGOAOXXXXXXXXXXXXXXXXXXGAOAOAXXXXXXXXXXXXXXXXGAOAXXXXXXXXXXXXXXXXXXGOAOXXXXXXXXXXXXXXXXXXGOOOXXXXXXXXXXXXXXXXXXGOOAAAAAXXXXXXXXXXXXXXGOOAXXXXXXXXXXXXXXXXXXGOOAAXXXXXXXXXXXXXXXXXGAOOXXXXXXXXXXXXXXXXXXGOOOAXXXXXXXXXXXXXXXXXGOOOOAAAAAOAOAAAAAAXXX,0,523,77
11802,81,33,48,171,270,0,0,396,317,79,GOOOAOOXXXXXXXXXXXXXXXGOOAAOAAXXXXXXXXXXXXXXGOAOXXXXXXXXXXXXXXXXXXGAOAOAXXXXXXXXXXXXXXXXGAOAXXXXXXXXXXXXXXXXXXGOAXXXXXXXXXXXXXXXXXXXGOOOXXXXXXXXXXXXXXXXXXGOOAAAAAXXXXXXXXXXXXXXGOOAXXXXXXXXXXXXXXXXXXGOOAAXXXXXXXXXXXXXXXXXGAOOXXXXXXXXXXXXXXXXXXGOOOAXXXXXXXXXXXXXXXXXGOOOOAAAAAOAOAAAOAAXXX,0,522,78
11823,81,32,49,176,264,0,0,392,312,80,GOOOAOOAXXXXXXXXXXXXXXGOOAAOAAXXXXXXXXXXXXXXGOAOXXXXXXXXXXXXXXXXXXGOOAOAXXXXXXXXXXXXXXXXGAOAXXXXXXXXXXXXXXXXXXGOAXXXXXXXXXXXXXXXXXXXGOOOXXXXXXXXXXXXXXXXXXGOOAAAAAXXXXXXXXXXXXXXGOOAXXXXXXXXXXXXXXXXXXGOOAAXXXXXXXXXXXXXXXXXGAOOXXXXXXXXXXXXXXXXXXGOOOAXXXXXXXXXXXXXXXXXGOOOOAXAAAOAOAAAOAAXXX,0,521,79
11844,69,23,46,178,274,0,0,399,311,88,GOOOAOOAXXXXXXXXXXXXXXGOOAAOAAXXXXXXXXXXXXXXGOAOXXXXXXXXXXXXXXXXXXGOOAOAXXXXXXXXXXXXXXXXGAOAXXXXXXXXXXXXXXXXXXGOAXXXXXXXXXXXXXXXXXXXGOOOXXXXXXXXXXXXXXXXXXGOOAAAAAXXXXXXXXXXXXXXGOOAXXXXXXXXXXXXXXXXXXGOOAAXXXXXXXXXXXXXXXXXGAOOXXXXXXXXXXXXXXXXXXGOOOAXXXXXXXXXXXXXXXXXGOOOOAXXXXXXXXXXXXXXXX,0,521,79

11865,72,25,47,178,270,0,0,397,308,89,GOOOXOOAXXXXXXXXXXXXXXGOOAAOAOXXXXXXXXXXXXXXGOAOXXXXXXXXXXXXXXXXXXGOOAOAXXXXXXXXXXXXXXXXGAOAAXXXXXXXXXXXXXXXXXGOAAXXXXXXXXXXXXXXXXXXGOOOXXXXXXXXXXXXXXXXXXGOOAAAAAXXXXXXXXXXXXXXGOOAXXXXXXXXXXXXXXXXXXGOOAAXXXXXXXXXXXXXXXXXGAOOXXXXXXXXXXXXXXXXXXGOOOAXXXXXXXXXXXXXXXXXGOOOOAAAXXXXXXXXXXXXXX,0,520,80
11886,74,27,47,171,275,0,0,402,313,89,GOOOXOOAXXXXXXXXXXXXXXGOOAAOAOXXXXXXXXXXXXXXGOAOAXXXXXXXXXXXXXXXXXGOOAOAXXXXXXXXXXXXXXXXGAOAAXXXXXXXXXXXXXXXXXGOAAXXXXXXXXXXXXXXXXXXGOOOAXXXXXXXXXXXXXXXXXGOOAAAAAXXXXXXXXXXXXXXGOOAXXXXXXXXXXXXXXXXXXGOOAAXXXXXXXXXXXXXXXXXGAOOXXXXXXXXXXXXXXXXXXGOOOAXXXXXXXXXXXXXXXXXGOOOOAAAXXXXXXXXXXXXXX,0,520,80
11907,72,27,45,171,275,0,0,402,313,89,GOOOXOOAXXXXXXXXXXXXXXGOOAAOAOXXXXXXXXXXXXXXGOAOAXXXXXXXXXXXXXXXXXGOOAXAXXXXXXXXXXXXXXXXGAOAAXXXXXXXXXXXXXXXXXGXAAXXXXXXXXXXXXXXXXXXGOOOAXXXXXXXXXXXXXXXXXGOOAAAAAXXXXXXXXXXXXXXGOOAXXXXXXXXXXXXXXXXXXGOOAAXXXXXXXXXXXXXXXXXGAOOXXXXXXXXXXXXXXXXXXGOOOAXXXXXXXXXXXXXXXXXGOOOOAAAXXXXXXXXXXXXXX,0,518,82
11928,72,27,45,170,276,0,0,403,315,88,GOOOXOOAXXXXXXXXXXXXXXGOOAAOAOXXXXXXXXXXXXXXGOAOAXXXXXXXXXXXXXXXXXGOOAXAXXXXXXXXXXXXXXXXGAOAAXXXXXXXXXXXXXXXXXGXAAXXXXXXXXXXXXXXXXXXGOOOAXXXXXXXXXXXXXXXXXGOOAAAAAXXXXXXXXXXXXXXGOOAXXXXXXXXXXXXXXXXXXGOOAAXXXXXXXXXXXXXXXXXGAOOXXXXXXXXXXXXXXXXXXGOOOAXXXXXXXXXXXXXXXXXGOOOOAAAXXXXXXXXXXXXXX,0,518,82
11949,72,26,46,169,277,0,0,404,311,93,GOOOXOOAXXXXXXXXXXXXXXGOOAAOAOXXXXXXXXXXXXXXGOAOAXXXXXXXXXXXXXXXXXGOOAXXXXXXXXXXXXXXXXXXGAOAAXXXXXXXXXXXXXXXXXGXAAXXXXXXXXXXXXXXXXXXGOOOAXXXXXXXXXXXXXXXXXGOOAOAAAXXXXXXXXXXXXXXGOOAXXXXXXXXXXXXXXXXXXGOOAAXXXXXXXXXXXXXXXXXGAOOXXXXXXXXXXXXXXXXXXGOOOAXXXXXXXXXXXXXXXXXGOOOOAAAAXXXXXXXXXXXXX,0,518,82

11970,70,24,46,174,272,0,0,402,305,97,GXXOXOOAXXXXXXXXXXXXXXGOOOAOAOXXXXXXXXXXXXXXGOAOAXXXXXXXXXXXXXXXXXGOOOXXXXXXXXXXXXXXXXXXGAOAAXXXXXXXXXXXXXXXXXGXAAXXXXXXXXXXXXXXXXXXGOOOAXXXXXXXXXXXXXXXXXGOOAOAAAXXXXXXXXXXXXXXGOOAXXXXXXXXXXXXXXXXXXGOOAAXXXXXXXXXXXXXXXXXGAOOXXXXXXXXXXXXXXXXXXGOOOAXXXXXXXXXXXXXXXXXGOOOOAAAAXXXXXXXXXXXXX,0,516,84
11991,70,23,47,174,272,0,0,402,304,98,GXXOXOOOXXXXXXXXXXXXXXGOOOAOAOXXXXXXXXXXXXXXGOAOAXXXXXXXXXXXXXXXXXGOOOXXXXXXXXXXXXXXXXXXGAOAAXXXXXXXXXXXXXXXXXGXAAXXXXXXXXXXXXXXXXXXGOOOAXXXXXXXXXXXXXXXXXGOOAOAAAXXXXXXXXXXXXXXGOOAXXXXXXXXXXXXXXXXXXGOOAAXXXXXXXXXXXXXXXXXGAOOXXXXXXXXXXXXXXXXXXGOOOAXXXXXXXXXXXXXXXXXGOOOOAAAAXXXXXXXXXXXXX,0,516,84
12012,70,22,48,169,277,0,0,408,311,97,GXXOXOOOXXXXXXXXXXXXXXGOOOAOAOXXXXXXXXXXXXXXGOAOAXXXXXXXXXXXXXXXXXGOOOXXXXXXXXXXXXXXXXXXGAOAAXXXXXXXXXXXXXXXXXGXAAXXXXXXXXXXXXXXXXXXGOOOAXXXXXXXXXXXXXXXXXGOOAOAAAXXXXXXXXXXXXXXGOOAXXXXXXXXXXXXXXXXXXGOOAAXXXXXXXXXXXXXXXXXGAOOXXXXXXXXXXXXXXXXXXGOOOAXXXXXXXXXXXXXXXXXGOOOOAOAAXXXXXXXXXXXXX,0,516,84
12033,69,22,47,168,278,0,0,410,317,93,GXXOXOOOXXXXXXXXXXXXXXGOOOAOAOXXXXXXXXXXXXXXGOAOAXXXXXXXXXXXXXXXXXGOOOXXXXXXXXXXXXXXXXXXGAOAAXXXXXXXXXXXXXXXXXGXAAXXXXXXXXXXXXXXXXXXGOOOAXXXXXXXXXXXXXXXXXGOOAXAAAXXXXXXXXXXXXXXGOOAXXXXXXXXXXXXXXXXXXGOOAAXXXXXXXXXXXXXXXXXGAOOXXXXXXXXXXXXXXXXXXGOOOAXXXXXXXXXXXXXXXXXGOOOOAOAAXXXXXXXXXXXXX,0,515,85
12054,70,23,47,172,273,0,0,405,317,88,GAXOXOOOXXXXXXXXXXXXXXGOOOAOAOXXXXXXXXXXXXXXGOAOAXXXXXXXXXXXXXXXXXGOOOXXXXXXXXXXXXXXXXXXGAOAAXXXXXXXXXXXXXXXXXGXAAXXXXXXXXXXXXXXXXXXGOOOAXXXXXXXXXXXXXXXXXGOOAXAAAXXXXXXXXXXXXXXGOOAXXXXXXXXXXXXXXXXXXGOOAAXXXXXXXXXXXXXXXXXGAOOXXXXXXXXXXXXXXXXXXGOOOAXXXXXXXXXXXXXXXXXGOOOOAOAAXXXXXXXXXXXXX,0,515,85

12075,67,19,48,170,278,0,0,411,320,91,GOXOXOOOXXXXXXXXXXXXXXGOOOAOAOXXXXXXXXXXXXXXGOAOAXXXXXXXXXXXXXXXXXGOOOXXXXXXXXXXXXXXXXXXGAOAAXXXXXXXXXXXXXXXXXGXAAXXXXXXXXXXXXXXXXXXGOOOAXXXXXXXXXXXXXXXXXGOOAXXXXXXXXXXXXXXXXXXGOOAXXXXXXXXXXXXXXXXXXGOOAAXXXXXXXXXXXXXXXXXGAOOXXXXXXXXXXXXXXXXXXGOOOAXXXXXXXXXXXXXXXXXGOOOOAOAAXXXXXXXXXXXXX,0,515,85
12096,67,19,48,170,278,0,0,410,323,87,GOXOXOOOXXXXXXXXXXXXXXGOOOAOAOXXXXXXXXXXXXXXGOAOAXXXXXXXXXXXXXXXXXGOOOXXXXXXXXXXXXXXXXXXGAOAAXXXXXXXXXXXXXXXXXGXAAXXXXXXXXXXXXXXXXXXGOOOAXXXXXXXXXXXXXXXXXGOOAXXXXXXXXXXXXXXXXXXGOOAXXXXXXXXXXXXXXXXXXGOOAAXXXXXXXXXXXXXXXXXGAOOXXXXXXXXXXXXXXXXXXGOOOAXXXXXXXXXXXXXXXXXGOOOOAOAAXXXXXXXXXXXXX,0,515,85
12117,67,19,48,177,271,0,0,404,323,81,GOXOXOOOXXXXXXXXXXXXXXGOOOAOAOXXXXXXXXXXXXXXGOAOAXXXXXXXXXXXXXXXXXGOOOXXXXXXXXXXXXXXXXXXGAOAAXXXXXXXXXXXXXXXXXGXAAXXXXXXXXXXXXXXXXXXGOOOAXXXXXXXXXXXXXXXXXGOOAXXXXXXXXXXXXXXXXXXGOOAXXXXXXXXXXXXXXXXXXGOOAAXXXXXXXXXXXXXXXXXGAOOXXXXXXXXXXXXXXXXXXGOOOAXXXXXXXXXXXXXXXXXGOOOOAOAAXXXXXXXXXXXXX,0,515,85
12138,67,20,47,180,267,0,0,400,323,77,GOXOXOOOXXXXXXXXXXXXXXGOOOAOAOXXXXXXXXXXXXXXGOAOAXXXXXXXXXXXXXXXXXGOOOXXXXXXXXXXXXXXXXXXGAOAAXXXXXXXXXXXXXXXXXGXAAXXXXXXXXXXXXXXXXXXGOOOAXXXXXXXXXXXXXXXXXGXOAXXXXXXXXXXXXXXXXXXGOOAXXXXXXXXXXXXXXXXXXGOOAAXXXXXXXXXXXXXXXXXGAOOXXXXXXXXXXXXXXXXXXGOOOAXXXXXXXXXXXXXXXXXGOOOOAOAAAXXXXXXXXXXXX,0,514,86
12159,68,20,48,177,269,0,0,403,325,78,GOXOXOOOXXXXXXXXXXXXXXGOOOAOAOXXXXXXXXXXXXXXGOAOAXXXXXXXXXXXXXXXXXGOOOXXXXXXXXXXXXXXXXXXGAOAAAXXXXXXXXXXXXXXXXGXAAXXXXXXXXXXXXXXXXXXGOOOAXXXXXXXXXXXXXXXXXGXOAXXXXXXXXXXXXXXXXXXGOOAXXXXXXXXXXXXXXXXXXGOOAAXXXXXXXXXXXXXXXXXGAOOXXXXXXXXXXXXXXXXXXGOOOAXXXXXXXXXXXXXXXXXGOOOOAOAOAXXXXXXXXXXXX,0,514,86

12180,68,21,47,181,263,0,0,399,319,80,GOAOXOOOXXXXXXXXXXXXXXGOOOAOAOXXXXXXXXXXXXXXGOAOAXXXXXXXXXXXXXXXXXGOOOXXXXXXXXXXXXXXXXXXGAOAAAXXXXXXXXXXXXXXXXGAOAXXXXXXXXXXXXXXXXXXGOOOAXXXXXXXXXXXXXXXXXGXOAXXXXXXXXXXXXXXXXXXGOOAXXXXXXXXXXXXXXXXXXGOOAAXXXXXXXXXXXXXXXXXGAXOXXXXXXXXXXXXXXXXXXGOOOAXXXXXXXXXXXXXXXXXGXOOOAOAOAXXXXXXXXXXXX,0,512,88
12201,69,22,47,184,259,0,0,395,315,80,GOAOXOOOXXXXXXXXXXXXXXGOOOAOAOXXXXXXXXXXXXXXGOAOAXXXXXXXXXXXXXXXXXGOOOXXXXXXXXXXXXXXXXXXGAOAAAXXXXXXXXXXXXXXXXGAOAXXXXXXXXXXXXXXXXXXGOOOAXXXXXXXXXXXXXXXXXGAOAXXXXXXXXXXXXXXXXXXGOOAXXXXXXXXXXXXXXXXXXGOOAAXXXXXXXXXXXXXXXXXGAXOXXXXXXXXXXXXXXXXXXGOOOAXXXXXXXXXXXXXXXXXGXOOOAOAOAXXXXXXXXXXXX,0,512,88
12222,69,21,48,187,256,0,0,393,309,84,GOAOXOOOXXXXXXXXXXXXXXGOOOAOAOXXXXXXXXXXXXXXGOAOOXXXXXXXXXXXXXXXXXGOOOXXXXXXXXXXXXXXXXXXGAOAAAXXXXXXXXXXXXXXXXGAOAXXXXXXXXXXXXXXXXXXGOOOAXXXXXXXXXXXXXXXXXGAOAXXXXXXXXXXXXXXXXXXGOOAXXXXXXXXXXXXXXXXXXGOOAAXXXXXXXXXXXXXXXXXGAXOXXXXXXXXXXXXXXXXXXGOOOAXXXXXXXXXXXXXXXXXGXOOOAOAOAXXXXXXXXXXXX,0,512,88
12243,69,20,49,187,256,0,0,394,310,84,GOAOXOOOXXXXXXXXXXXXXXGOOOAOAOXXXXXXXXXXXXXXGOAOOXXXXXXXXXXXXXXXXXGOOOXXXXXXXXXXXXXXXXXXGAOAAAXXXXXXXXXXXXXXXXGAOAXXXXXXXXXXXXXXXXXXGOOOAXXXXXXXXXXXXXXXXXGAOAXXXXXXXXXXXXXXXXXXGOOOXXXXXXXXXXXXXXXXXXGOOAAXXXXXXXXXXXXXXXXXGAXOXXXXXXXXXXXXXXXXXXGOOOAXXXXXXXXXXXXXXXXXGXOOOAOAOAXXXXXXXXXXXX,0,512,88
12264,71,21,50,188,253,0,0,391,307,84,GOAOXOOOXXXXXXXXXXXXXXGOOOOOAOXXXXXXXXXXXXXXGOAOOXXXXXXXXXXXXXXXXXGOOOAXXXXXXXXXXXXXXXXXGAOAAAXXXXXXXXXXXXXXXXGAOAXXXXXXXXXXXXXXXXXXGOOOAXXXXXXXXXXXXXXXXXGAOAXXXXXXXXXXXXXXXXXXGOOOXXXXXXXXXXXXXXXXXXGOOAAXXXXXXXXXXXXXXXXXGAXOAXXXXXXXXXXXXXXXXXGOOOAXXXXXXXXXXXXXXXXXGXOOOAOAOAXXXXXXXXXXXX,0,512,88

12285,71,21,50,189,252,0,0,390,304,86,GOAOXOOOXXXXXXXXXXXXXXGOOOOOAOXXXXXXXXXXXXXXGOAOOXXXXXXXXXXXXXXXXXGOOOAXXXXXXXXXXXXXXXXXGAOAAAXXXXXXXXXXXXXXXXGAOAXXXXXXXXXXXXXXXXXXGOOOAXXXXXXXXXXXXXXXXXGAOAXXXXXXXXXXXXXXXXXXGOOOXXXXXXXXXXXXXXXXXXGOOAAXXXXXXXXXXXXXXXXXGAXOAXXXXXXXXXXXXXXXXXGOOOAXXXXXXXXXXXXXXXXXGXOOOAOAOAXXXXXXXXXXXX,0,512,88
12306,70,21,49,189,252,0,0,391,309,82,GOAOXOOOXXXXXXXXXXXXXXGOOOOOAOXXXXXXXXXXXXXXGOAOOXXXXXXXXXXXXXXXXXGOOOAXXXXXXXXXXXXXXXXXGAXAAAXXXXXXXXXXXXXXXXGAOAXXXXXXXXXXXXXXXXXXGOOOAXXXXXXXXXXXXXXXXXGAOAXXXXXXXXXXXXXXXXXXGOOOXXXXXXXXXXXXXXXXXXGOOAAXXXXXXXXXXXXXXXXXGAXOAXXXXXXXXXXXXXXXXXGOOOAXXXXXXXXXXXXXXXXXGXOOOAOAOAXXXXXXXXXXXX,0,511,89
12327,70,21,49,193,247,0,0,387,305,82,GOAOXOOOXXXXXXXXXXXXXXGOOOOOAOXXXXXXXXXXXXXXGOAOOXXXXXXXXXXXXXXXXXGOXOAXXXXXXXXXXXXXXXXXGOXAAAXXXXXXXXXXXXXXXXGAOAXXXXXXXXXXXXXXXXXXGOOOAXXXXXXXXXXXXXXXXXGAOAXXXXXXXXXXXXXXXXXXGOOOXXXXXXXXXXXXXXXXXXGOOAAAXXXXXXXXXXXXXXXXGAXOAXXXXXXXXXXXXXXXXXGOOOAXXXXXXXXXXXXXXXXXGXOOOAOAOAXXXXXXXXXXXX,0,510,90
12348,72,23,49,192,246,0,0,385,308,77,GOAOAOOOXXXXXXXXXXXXXXGOOOOOAOXXXXXXXXXXXXXXGOAOOXXXXXXXXXXXXXXXXXGOXOAXXXXXXXXXXXXXXXXXGOXAAAXXXXXXXXXXXXXXXXGAOAXXXXXXXXXXXXXXXXXXGOOOAAXXXXXXXXXXXXXXXXGAOAXXXXXXXXXXXXXXXXXXGOOOXXXXXXXXXXXXXXXXXXGOOAAAXXXXXXXXXXXXXXXXGAXOAXXXXXXXXXXXXXXXXXGOOOAXXXXXXXXXXXXXXXXXGXOOOAOAOAXXXXXXXXXXXX,0,510,90
12369,72,22,50,194,243,0,0,385,305,80,GOAOAOOOAXXXXXXXXXXXXXGOOOOOAOXXXXXXXXXXXXXXGOAOOXXXXXXXXXXXXXXXXXGOXOAXXXXXXXXXXXXXXXXXGOXAAAXXXXXXXXXXXXXXXXGAOAXXXXXXXXXXXXXXXXXXGOOOAAXXXXXXXXXXXXXXXXGAOAXXXXXXXXXXXXXXXXXXGOOOXXXXXXXXXXXXXXXXXXGOOAXAXXXXXXXXXXXXXXXXGAXOOXXXXXXXXXXXXXXXXXGOOOAXXXXXXXXXXXXXXXXXGXOOOAOAOAXXXXXXXXXXXX,0,509,91

12390,71,21,50,193,244,0,0,387,306,81,GOAOAOOOAXXXXXXXXXXXXXGOOOOOAOXXXXXXXXXXXXXXGOAOOXXXXXXXXXXXXXXXXXGOXOAXXXXXXXXXXXXXXXXXGOXAAAXXXXXXXXXXXXXXXXGAXAAXXXXXXXXXXXXXXXXXGOOOAOXXXXXXXXXXXXXXXXGAOAXXXXXXXXXXXXXXXXXXGOOOXXXXXXXXXXXXXXXXXXGOOAXXXXXXXXXXXXXXXXXXGAXOOXXXXXXXXXXXXXXXXXGOOOAXXXXXXXXXXXXXXXXXGXOOOAOAOAXXXXXXXXXXXX,0,508,92
12411,73,22,51,193,242,0,0,386,304,82,GOAOAOOOAXXXXXXXXXXXXXGOOOOOAOXXXXXXXXXXXXXXGOAOOXXXXXXXXXXXXXXXXXGOXOAAXXXXXXXXXXXXXXXXGOXAAAXXXXXXXXXXXXXXXXGAXOAXXXXXXXXXXXXXXXXXGOOOAOXXXXXXXXXXXXXXXXGAOAXXXXXXXXXXXXXXXXXXGOOOXXXXXXXXXXXXXXXXXXGOOAXXXXXXXXXXXXXXXXXXGAAOOXXXXXXXXXXXXXXXXXGOOOAXXXXXXXXXXXXXXXXXGXOOOAOAOAXXXXXXXXXXXX,0,508,92
12432,73,22,51,190,245,0,0,388,304,84,GOAOAOOOAXXXXXXXXXXXXXGOOOOOAOXXXXXXXXXXXXXXGOAOOXXXXXXXXXXXXXXXXXGOXOAAXXXXXXXXXXXXXXXXGOXAAAXXXXXXXXXXXXXXXXGAXOAXXXXXXXXXXXXXXXXXGOOOAOXXXXXXXXXXXXXXXXGAOAXXXXXXXXXXXXXXXXXXGOOOXXXXXXXXXXXXXXXXXXGOOAXXXXXXXXXXXXXXXXXXGAAOOXXXXXXXXXXXXXXXXXGOOOAXXXXXXXXXXXXXXXXXGXOOOAOAOAXXXXXXXXXXXX,0,508,92
12453,74,22,52,189,245,0,0,388,305,83,GOAOAOOOAXXXXXXXXXXXXXGOOOOOAOXXXXXXXXXXXXXXGOAOOXXXXXXXXXXXXXXXXXGOXOAAXXXXXXXXXXXXXXXXGOXAOAXXXXXXXXXXXXXXXXGAXOAXXXXXXXXXXXXXXXXXGOOOAOXXXXXXXXXXXXXXXXGAOAXXXXXXXXXXXXXXXXXXGOOOXXXXXXXXXXXXXXXXXXGOOAXXXXXXXXXXXXXXXXXXGAAOOXXXXXXXXXXXXXXXXXGOOOAXXXXXXXXXXXXXXXXXGXOOOAOAOAAXXXXXXXXXXX,0,508,92
12474,74,22,52,185,249,0,0,393,306,87,GOAOAOOOAXXXXXXXXXXXXXGOOOOOAOXXXXXXXXXXXXXXGOAOOXXXXXXXXXXXXXXXXXGOXOAAXXXXXXXXXXXXXXXXGOXAOAXXXXXXXXXXXXXXXXGAXOAXXXXXXXXXXXXXXXXXGOOOAOXXXXXXXXXXXXXXXXGAOAXXXXXXXXXXXXXXXXXXGOOOXXXXXXXXXXXXXXXXXXGOOAXXXXXXXXXXXXXXXXXXGAAOOXXXXXXXXXXXXXXXXXGOOOAXXXXXXXXXXXXXXXXXGXOOOAOAOAAXXXXXXXXXXX,0,508,92

12495,74,23,51,183,250,0,0,395,306,89,GOAOAOOOAXXXXXXXXXXXXXGOOOOOAOXXXXXXXXXXXXXXGXAOOXXXXXXXXXXXXXXXXXGOXOAAXXXXXXXXXXXXXXXXGOAAOAXXXXXXXXXXXXXXXXGAXOAXXXXXXXXXXXXXXXXXGOOOAOXXXXXXXXXXXXXXXXGAOAXXXXXXXXXXXXXXXXXXGOOOXXXXXXXXXXXXXXXXXXGOOAXXXXXXXXXXXXXXXXXXGAAOOXXXXXXXXXXXXXXXXXGOOOAXXXXXXXXXXXXXXXXXGXOOOAOAOAAXXXXXXXXXXX,0,507,93
12516,75,23,52,188,244,0,0,390,305,85,GOAOAOOOAXXXXXXXXXXXXXGOOOOOAOXXXXXXXXXXXXXXGAAOOXXXXXXXXXXXXXXXXXGOXOAAXXXXXXXXXXXXXXXXGOAAOAXXXXXXXXXXXXXXXXGAXOAXXXXXXXXXXXXXXXXXGOOOOOXXXXXXXXXXXXXXXXGAOAXXXXXXXXXXXXXXXXXXGOOOXXXXXXXXXXXXXXXXXXGOOAXXXXXXXXXXXXXXXXXXGAAOOXXXXXXXXXXXXXXXXXGOOOAXXXXXXXXXXXXXXXXXGXOOOAOAOAAXXXXXXXXXXX,0,507,93
12537,74,22,52,189,243,0,0,390,302,88,GOAOAOOOAXXXXXXXXXXXXXGOOOOOAOXXXXXXXXXXXXXXGAAOOXXXXXXXXXXXXXXXXXGOXOAAXXXXXXXXXXXXXXXXGOAAOAXXXXXXXXXXXXXXXXGAXOAXXXXXXXXXXXXXXXXXGOOOOOXXXXXXXXXXXXXXXXGAOAXXXXXXXXXXXXXXXXXXGOOOXXXXXXXXXXXXXXXXXXGOOAXXXXXXXXXXXXXXXXXXGAAOOXXXXXXXXXXXXXXXXXGOOOAXXXXXXXXXXXXXXXXXGXOXOAOAOAOXXXXXXXXXXX,0,506,94
12558,60,17,43,186,260,0,0,398,310,88,GOAOAXXXXXXXXXXXXXXXXXGOOOOXXXXXXXXXXXXXXXXXGAAOOXXXXXXXXXXXXXXXXXGOXOAAXXXXXXXXXXXXXXXXGOAAOAXXXXXXXXXXXXXXXXGAXOAXXXXXXXXXXXXXXXXXGOOOOOXXXXXXXXXXXXXXXXGAOAXXXXXXXXXXXXXXXXXXGOOOXXXXXXXXXXXXXXXXXXGOOAXXXXXXXXXXXXXXXXXXGAAOOXXXXXXXXXXXXXXXXXGOOOAXXXXXXXXXXXXXXXXXGXOXXXXXXXXXXXXXXXXXXX,0,506,94
12579,60,18,42,186,259,0,0,396,307,89,GOAOAXXXXXXXXXXXXXXXXXGOOOOXXXXXXXXXXXXXXXXXGAAOOXXXXXXXXXXXXXXXXXGOXOAAXXXXXXXXXXXXXXXXGOAAOAXXXXXXXXXXXXXXXXGAXOAXXXXXXXXXXXXXXXXXGOOOOOXXXXXXXXXXXXXXXXGAOAXXXXXXXXXXXXXXXXXXGOOOXXXXXXXXXXXXXXXXXXGOAAXXXXXXXXXXXXXXXXXXGAAOOXXXXXXXXXXXXXXXXXGOOOAXXXXXXXXXXXXXXXXXGXOXXXXXXXXXXXXXXXXXXX,0,505,95

12600,61,19,42,186,258,0,0,396,309,87,GOAOAXXXXXXXXXXXXXXXXXGOOOOXXXXXXXXXXXXXXXXXGAAOOAXXXXXXXXXXXXXXXXGOXOAAXXXXXXXXXXXXXXXXGOAAOAXXXXXXXXXXXXXXXXGAXOAXXXXXXXXXXXXXXXXXGOOOOOXXXXXXXXXXXXXXXXGAOAXXXXXXXXXXXXXXXXXXGOOOXXXXXXXXXXXXXXXXXXGOAAXXXXXXXXXXXXXXXXXXGAAOOXXXXXXXXXXXXXXXXXGOOOAXXXXXXXXXXXXXXXXXGXOXXXXXXXXXXXXXXXXXXX,0,505,95
12621,58,18,40,186,258,0,0,396,306,90,GOAOAXXXXXXXXXXXXXXXXXGOOOOXXXXXXXXXXXXXXXXXGAAOOAXXXXXXXXXXXXXXXXGOXOAAXXXXXXXXXXXXXXXXGOAAOAXXXXXXXXXXXXXXXXGAXOAXXXXXXXXXXXXXXXXXGXOOOOXXXXXXXXXXXXXXXXGOOAXXXXXXXXXXXXXXXXXXGOOOXXXXXXXXXXXXXXXXXXGXAAXXXXXXXXXXXXXXXXXXGAAOOXXXXXXXXXXXXXXXXXGOOOAXXXXXXXXXXXXXXXXXGXXXXXXXXXXXXXXXXXXXXX,0,502,98
12642,57,17,40,179,265,0,0,405,308,97,GOAOAXXXXXXXXXXXXXXXXXGOOOOXXXXXXXXXXXXXXXXXGAAOOAXXXXXXXXXXXXXXXXGOXOAAXXXXXXXXXXXXXXXXGOOAOAXXXXXXXXXXXXXXXXGAXOAXXXXXXXXXXXXXXXXXGXOOOOXXXXXXXXXXXXXXXXGOOAXXXXXXXXXXXXXXXXXXGOOOXXXXXXXXXXXXXXXXXXGXAAXXXXXXXXXXXXXXXXXXGAAOOXXXXXXXXXXXXXXXXXGOOXAXXXXXXXXXXXXXXXXXGXXXXXXXXXXXXXXXXXXXXX,0,501,99
12663,37,10,27,172,292,0,0,417,311,106,GOAXXXXXXXXXXXXXXXXXXXGOXXXXXXXXXXXXXXXXXXXXGAXXXXXXXXXXXXXXXXXXXXGOXXXXXXXXXXXXXXXXXXXXGOOXXXXXXXXXXXXXXXXXXXGAXXXXXXXXXXXXXXXXXXXXGXXXXXXXXXXXXXXXXXXXXXGOOAXXXXXXXXXXXXXXXXXXGOOOXXXXXXXXXXXXXXXXXXGXAAXXXXXXXXXXXXXXXXXXGAAOOXXXXXXXXXXXXXXXXXGOOXAXXXXXXXXXXXXXXXXXGAXXXXXXXXXXXXXXXXXXXX,0,501,99
12684,30,7,23,175,296,0,0,418,309,109,GOAXXXXXXXXXXXXXXXXXXXGOXXXXXXXXXXXXXXXXXXXXGAXXXXXXXXXXXXXXXXXXXXGOXXXXXXXXXXXXXXXXXXXXGOOXXXXXXXXXXXXXXXXXXXGAXXXXXXXXXXXXXXXXXXXXGXXXXXXXXXXXXXXXXXXXXXGOXXXXXXXXXXXXXXXXXXXXGOOXXXXXXXXXXXXXXXXXXXGXAXXXXXXXXXXXXXXXXXXXGAAXXXXXXXXXXXXXXXXXXXGOOXXXXXXXXXXXXXXXXXXXGAXXXXXXXXXXXXXXXXXXXX,0,501,99

12705,32,9,23,174,295,0,0,417,307,110,GOAXXXXXXXXXXXXXXXXXXXGOXXXXXXXXXXXXXXXXXXXXGAXXXXXXXXXXXXXXXXXXXXGOXXXXXXXXXXXXXXXXXXXXGOOXXXXXXXXXXXXXXXXXXXGAXXXXXXXXXXXXXXXXXXXXGAXXXXXXXXXXXXXXXXXXXXGOXXXXXXXXXXXXXXXXXXXXGOOAXXXXXXXXXXXXXXXXXXGXAXXXXXXXXXXXXXXXXXXXGAAXXXXXXXXXXXXXXXXXXXGOOXXXXXXXXXXXXXXXXXXXGAXXXXXXXXXXXXXXXXXXXX,0,501,99
12726,33,11,22,175,292,0,0,414,308,106,GOAXXXXXXXXXXXXXXXXXXXGOXXXXXXXXXXXXXXXXXXXXGAXXXXXXXXXXXXXXXXXXXXGOXXXXXXXXXXXXXXXXXXXXGOOAXXXXXXXXXXXXXXXXXXGAXXXXXXXXXXXXXXXXXXXXGAXXXXXXXXXXXXXXXXXXXXGOAXXXXXXXXXXXXXXXXXXXGOOAXXXXXXXXXXXXXXXXXXGXAXXXXXXXXXXXXXXXXXXXGAAXXXXXXXXXXXXXXXXXXXGXOXXXXXXXXXXXXXXXXXXXGAXXXXXXXXXXXXXXXXXXXX,0,500,100
12747,34,13,21,181,285,0,0,406,306,100,GOAXXXXXXXXXXXXXXXXXXXGOXXXXXXXXXXXXXXXXXXXXGAXXXXXXXXXXXXXXXXXXXXGOXXXXXXXXXXXXXXXXXXXXGOOAXXXXXXXXXXXXXXXXXXGAXXXXXXXXXXXXXXXXXXXXGAXXXXXXXXXXXXXXXXXXXXGOAXXXXXXXXXXXXXXXXXXXGOOAXXXXXXXXXXXXXXXXXXGXAAXXXXXXXXXXXXXXXXXXGAAXXXXXXXXXXXXXXXXXXXGAXXXXXXXXXXXXXXXXXXXXGAXXXXXXXXXXXXXXXXXXXX,0,500,100
12768,35,14,21,182,283,0,0,404,308,96,GOAAXXXXXXXXXXXXXXXXXXGOXXXXXXXXXXXXXXXXXXXXGAXXXXXXXXXXXXXXXXXXXXGOXXXXXXXXXXXXXXXXXXXXGOOAXXXXXXXXXXXXXXXXXXGAXXXXXXXXXXXXXXXXXXXXGAXXXXXXXXXXXXXXXXXXXXGOAXXXXXXXXXXXXXXXXXXXGOOAXXXXXXXXXXXXXXXXXXGXAAXXXXXXXXXXXXXXXXXXGAAXXXXXXXXXXXXXXXXXXXGAXXXXXXXXXXXXXXXXXXXXGAXXXXXXXXXXXXXXXXXXXX,0,500,100
12789,35,14,21,184,281,0,0,402,310,92,GOAAXXXXXXXXXXXXXXXXXXGOXXXXXXXXXXXXXXXXXXXXGAXXXXXXXXXXXXXXXXXXXXGOXXXXXXXXXXXXXXXXXXXXGOOAXXXXXXXXXXXXXXXXXXGAXXXXXXXXXXXXXXXXXXXXGAXXXXXXXXXXXXXXXXXXXXGOAXXXXXXXXXXXXXXXXXXXGOOAXXXXXXXXXXXXXXXXXXGXAAXXXXXXXXXXXXXXXXXXGAAXXXXXXXXXXXXXXXXXXXGAXXXXXXXXXXXXXXXXXXXXGAXXXXXXXXXXXXXXXXXXXX,0,500,100

12810,36,14,22,184,280,0,0,400,310,90,GOAAXXXXXXXXXXXXXXXXXXGOXXXXXXXXXXXXXXXXXXXXGAXXXXXXXXXXXXXXXXXXXXGOXXXXXXXXXXXXXXXXXXXXGOOAXXXXXXXXXXXXXXXXXXGOXXXXXXXXXXXXXXXXXXXXGAXXXXXXXXXXXXXXXXXXXXGOAXXXXXXXXXXXXXXXXXXXGOOAXXXXXXXXXXXXXXXXXXGXAAAXXXXXXXXXXXXXXXXXGAAXXXXXXXXXXXXXXXXXXXGAXXXXXXXXXXXXXXXXXXXXGAXXXXXXXXXXXXXXXXXXXX,0,500,100
12831,35,13,22,185,279,0,0,402,308,94,GOAAXXXXXXXXXXXXXXXXXXGXXXXXXXXXXXXXXXXXXXXXGAXXXXXXXXXXXXXXXXXXXXGOXXXXXXXXXXXXXXXXXXXXGOOAXXXXXXXXXXXXXXXXXXGOXXXXXXXXXXXXXXXXXXXXGAXXXXXXXXXXXXXXXXXXXXGOAXXXXXXXXXXXXXXXXXXXGOOOXXXXXXXXXXXXXXXXXXGXAAAXXXXXXXXXXXXXXXXXGAAXXXXXXXXXXXXXXXXXXXGAXXXXXXXXXXXXXXXXXXXXGAXXXXXXXXXXXXXXXXXXXX,0,499,101
12852,35,13,22,182,282,0,0,405,305,100,GOAAXXXXXXXXXXXXXXXXXXGXXXXXXXXXXXXXXXXXXXXXGAXXXXXXXXXXXXXXXXXXXXGOXXXXXXXXXXXXXXXXXXXXGOOAXXXXXXXXXXXXXXXXXXGOXXXXXXXXXXXXXXXXXXXXGAXXXXXXXXXXXXXXXXXXXXGOAXXXXXXXXXXXXXXXXXXXGOOOXXXXXXXXXXXXXXXXXXGXAAAXXXXXXXXXXXXXXXXXGAAXXXXXXXXXXXXXXXXXXXGAXXXXXXXXXXXXXXXXXXXXGAXXXXXXXXXXXXXXXXXXXX,0,499,101
12873,36,14,22,182,281,0,0,404,299,105,GOAAXXXXXXXXXXXXXXXXXXGXXXXXXXXXXXXXXXXXXXXXGAXXXXXXXXXXXXXXXXXXXXGOXXXXXXXXXXXXXXXXXXXXGOOAXXXXXXXXXXXXXXXXXXGOXXXXXXXXXXXXXXXXXXXXGAXXXXXXXXXXXXXXXXXXXXGOAXXXXXXXXXXXXXXXXXXXGOOOXXXXXXXXXXXXXXXXXXGXAAAAXXXXXXXXXXXXXXXXGAAXXXXXXXXXXXXXXXXXXXGAXXXXXXXXXXXXXXXXXXXXGAXXXXXXXXXXXXXXXXXXXX,0,499,101
12894,37,14,23,188,274,0,0,398,297,101,GOAAXXXXXXXXXXXXXXXXXXGXXXXXXXXXXXXXXXXXXXXXGAXXXXXXXXXXXXXXXXXXXXGOXXXXXXXXXXXXXXXXXXXXGOOAXXXXXXXXXXXXXXXXXXGOXXXXXXXXXXXXXXXXXXXXGAXXXXXXXXXXXXXXXXXXXXGOAXXXXXXXXXXXXXXXXXXXGOOOXXXXXXXXXXXXXXXXXXGXAAAAOXXXXXXXXXXXXXXXGAAXXXXXXXXXXXXXXXXXXXGAXXXXXXXXXXXXXXXXXXXXGAXXXXXXXXXXXXXXXXXXXX,0,499,101

12915,38,14,24,189,272,0,0,397,293,104,GOAAXXXXXXXXXXXXXXXXXXGXXXXXXXXXXXXXXXXXXXXXGOXXXXXXXXXXXXXXXXXXXXGOXXXXXXXXXXXXXXXXXXXXGOOAAXXXXXXXXXXXXXXXXXGOXXXXXXXXXXXXXXXXXXXXGAXXXXXXXXXXXXXXXXXXXXGOAXXXXXXXXXXXXXXXXXXXGOOOXXXXXXXXXXXXXXXXXXGXAAAAOXXXXXXXXXXXXXXXGAAXXXXXXXXXXXXXXXXXXXGAXXXXXXXXXXXXXXXXXXXXGAXXXXXXXXXXXXXXXXXXXX,0,499,101
12936,38,13,25,191,270,0,0,396,297,99,GOAAXXXXXXXXXXXXXXXXXXGXXXXXXXXXXXXXXXXXXXXXGOXXXXXXXXXXXXXXXXXXXXGOXXXXXXXXXXXXXXXXXXXXGOOOAXXXXXXXXXXXXXXXXXGOXXXXXXXXXXXXXXXXXXXXGAXXXXXXXXXXXXXXXXXXXXGOAXXXXXXXXXXXXXXXXXXXGOOOXXXXXXXXXXXXXXXXXXGXAAAAOXXXXXXXXXXXXXXXGAAXXXXXXXXXXXXXXXXXXXGAXXXXXXXXXXXXXXXXXXXXGAXXXXXXXXXXXXXXXXXXXX,0,499,101
12957,38,12,26,192,269,0,0,396,299,97,GOAAXXXXXXXXXXXXXXXXXXGXXXXXXXXXXXXXXXXXXXXXGOXXXXXXXXXXXXXXXXXXXXGOXXXXXXXXXXXXXXXXXXXXGOOOAXXXXXXXXXXXXXXXXXGOXXXXXXXXXXXXXXXXXXXXGAXXXXXXXXXXXXXXXXXXXXGOOXXXXXXXXXXXXXXXXXXXGOOOXXXXXXXXXXXXXXXXXXGXAAAAOXXXXXXXXXXXXXXXGAAXXXXXXXXXXXXXXXXXXXGAXXXXXXXXXXXXXXXXXXXXGAXXXXXXXXXXXXXXXXXXXX,0,499,101
12978,38,12,26,190,271,0,0,398,306,92,GOAAXXXXXXXXXXXXXXXXXXGXXXXXXXXXXXXXXXXXXXXXGOXXXXXXXXXXXXXXXXXXXXGOXXXXXXXXXXXXXXXXXXXXGOOOAXXXXXXXXXXXXXXXXXGOXXXXXXXXXXXXXXXXXXXXGAXXXXXXXXXXXXXXXXXXXXGOOXXXXXXXXXXXXXXXXXXXGOOOXXXXXXXXXXXXXXXXXXGXAAAAOXXXXXXXXXXXXXXXGAAXXXXXXXXXXXXXXXXXXXGAXXXXXXXXXXXXXXXXXXXXGAXXXXXXXXXXXXXXXXXXXX,0,499,101
12999,37,12,25,191,270,0,0,396,307,89,GOAAXXXXXXXXXXXXXXXXXXGXXXXXXXXXXXXXXXXXXXXXGXXXXXXXXXXXXXXXXXXXXXGOXXXXXXXXXXXXXXXXXXXXGOOOAXXXXXXXXXXXXXXXXXGOXXXXXXXXXXXXXXXXXXXXGAXXXXXXXXXXXXXXXXXXXXGOOXXXXXXXXXXXXXXXXXXXGOOOXXXXXXXXXXXXXXXXXXGXAAAAOXXXXXXXXXXXXXXXGAAXXXXXXXXXXXXXXXXXXXGAXXXXXXXXXXXXXXXXXXXXGAXXXXXXXXXXXXXXXXXXXX,0,498,102

13020,39,14,25,191,268,0,0,395,301,94,GOAAXXXXXXXXXXXXXXXXXXGAXXXXXXXXXXXXXXXXXXXXGXXXXXXXXXXXXXXXXXXXXXGOXXXXXXXXXXXXXXXXXXXXGOOOAXXXXXXXXXXXXXXXXXGOXXXXXXXXXXXXXXXXXXXXGAXXXXXXXXXXXXXXXXXXXXGOOXXXXXXXXXXXXXXXXXXXGOOOAXXXXXXXXXXXXXXXXXGXAAAAOXXXXXXXXXXXXXXXGAAXXXXXXXXXXXXXXXXXXXGAXXXXXXXXXXXXXXXXXXXXGAXXXXXXXXXXXXXXXXXXXX,0,498,102
13041,39,14,25,193,266,0,0,392,300,92,GOAAXXXXXXXXXXXXXXXXXXGAXXXXXXXXXXXXXXXXXXXXGXXXXXXXXXXXXXXXXXXXXXGOXXXXXXXXXXXXXXXXXXXXGOOOAXXXXXXXXXXXXXXXXXGOXXXXXXXXXXXXXXXXXXXXGAXXXXXXXXXXXXXXXXXXXXGOOXXXXXXXXXXXXXXXXXXXGOOOAXXXXXXXXXXXXXXXXXGXAAAAOXXXXXXXXXXXXXXXGAAXXXXXXXXXXXXXXXXXXXGAXXXXXXXXXXXXXXXXXXXXGAXXXXXXXXXXXXXXXXXXXX,0,498,102
13062,40,14,26,189,269,0,0,397,311,86,GOAAXXXXXXXXXXXXXXXXXXGAAXXXXXXXXXXXXXXXXXXXGXXXXXXXXXXXXXXXXXXXXXGOXXXXXXXXXXXXXXXXXXXXGOOOAXXXXXXXXXXXXXXXXXGOXXXXXXXXXXXXXXXXXXXXGAXXXXXXXXXXXXXXXXXXXXGOOXXXXXXXXXXXXXXXXXXXGOOOAXXXXXXXXXXXXXXXXXGXAAAOOXXXXXXXXXXXXXXXGAAXXXXXXXXXXXXXXXXXXXGAXXXXXXXXXXXXXXXXXXXXGAXXXXXXXXXXXXXXXXXXXX,0,498,102
13083,41,14,27,188,269,0,0,398,311,87,GOAAXXXXXXXXXXXXXXXXXXGAAAXXXXXXXXXXXXXXXXXXGXXXXXXXXXXXXXXXXXXXXXGOXXXXXXXXXXXXXXXXXXXXGOOOAXXXXXXXXXXXXXXXXXGOXXXXXXXXXXXXXXXXXXXXGAXXXXXXXXXXXXXXXXXXXXGOOXXXXXXXXXXXXXXXXXXXGOOOAXXXXXXXXXXXXXXXXXGXAAAOOXXXXXXXXXXXXXXXGAOXXXXXXXXXXXXXXXXXXXGAXXXXXXXXXXXXXXXXXXXXGAXXXXXXXXXXXXXXXXXXXX,0,498,102
13104,41,14,27,190,267,0,0,396,313,83,GOAAXXXXXXXXXXXXXXXXXXGAAAXXXXXXXXXXXXXXXXXXGXXXXXXXXXXXXXXXXXXXXXGOXXXXXXXXXXXXXXXXXXXXGOOOAXXXXXXXXXXXXXXXXXGOXXXXXXXXXXXXXXXXXXXXGAXXXXXXXXXXXXXXXXXXXXGOOXXXXXXXXXXXXXXXXXXXGOOOAXXXXXXXXXXXXXXXXXGXAAAOOXXXXXXXXXXXXXXXGAOXXXXXXXXXXXXXXXXXXXGAXXXXXXXXXXXXXXXXXXXXGAXXXXXXXXXXXXXXXXXXXX,0,498,102

13125,41,13,28,192,265,0,0,395,318,77,GOAAXXXXXXXXXXXXXXXXXXGAAAXXXXXXXXXXXXXXXXXXGXXXXXXXXXXXXXXXXXXXXXGOXXXXXXXXXXXXXXXXXXXXGOOOAXXXXXXXXXXXXXXXXXGOXXXXXXXXXXXXXXXXXXXXGOXXXXXXXXXXXXXXXXXXXXGOOXXXXXXXXXXXXXXXXXXXGOOOAXXXXXXXXXXXXXXXXXGXAAAOOXXXXXXXXXXXXXXXGAOXXXXXXXXXXXXXXXXXXXGAXXXXXXXXXXXXXXXXXXXXGAXXXXXXXXXXXXXXXXXXXX,0,498,102
13146,40,12,28,192,265,0,0,396,318,78,GOAAXXXXXXXXXXXXXXXXXXGOAAXXXXXXXXXXXXXXXXXXGXXXXXXXXXXXXXXXXXXXXXGOXXXXXXXXXXXXXXXXXXXXGOOOAXXXXXXXXXXXXXXXXXGOXXXXXXXXXXXXXXXXXXXXGOXXXXXXXXXXXXXXXXXXXXGOOXXXXXXXXXXXXXXXXXXXGOOOAXXXXXXXXXXXXXXXXXGXAAAOXXXXXXXXXXXXXXXXGAOXXXXXXXXXXXXXXXXXXXGAXXXXXXXXXXXXXXXXXXXXGAXXXXXXXXXXXXXXXXXXXX,0,497,103
13167,40,10,30,189,268,0,0,401,317,84,GOAAXXXXXXXXXXXXXXXXXXGOAOXXXXXXXXXXXXXXXXXXGXXXXXXXXXXXXXXXXXXXXXGOXXXXXXXXXXXXXXXXXXXXGOOOAXXXXXXXXXXXXXXXXXGOXXXXXXXXXXXXXXXXXXXXGOXXXXXXXXXXXXXXXXXXXXGOOXXXXXXXXXXXXXXXXXXXGOOOAXXXXXXXXXXXXXXXXXGXAAAOXXXXXXXXXXXXXXXXGOOXXXXXXXXXXXXXXXXXXXGAXXXXXXXXXXXXXXXXXXXXGAXXXXXXXXXXXXXXXXXXXX,0,497,103
13188,40,9,31,192,265,0,0,399,316,83,GOAAXXXXXXXXXXXXXXXXXXGOOOXXXXXXXXXXXXXXXXXXGXXXXXXXXXXXXXXXXXXXXXGOXXXXXXXXXXXXXXXXXXXXGOOOAXXXXXXXXXXXXXXXXXGOXXXXXXXXXXXXXXXXXXXXGOXXXXXXXXXXXXXXXXXXXXGOOXXXXXXXXXXXXXXXXXXXGOOOAXXXXXXXXXXXXXXXXXGXAAAOXXXXXXXXXXXXXXXXGOOXXXXXXXXXXXXXXXXXXXGAXXXXXXXXXXXXXXXXXXXXGAXXXXXXXXXXXXXXXXXXXX,0,497,103
13209,43,12,31,191,263,0,0,397,317,80,GOAAXXXXXXXXXXXXXXXXXXGOOOXXXXXXXXXXXXXXXXXXGXXXXXXXXXXXXXXXXXXXXXGOXXXXXXXXXXXXXXXXXXXXGOOOAXXXXXXXXXXXXXXXXXGOXXXXXXXXXXXXXXXXXXXXGOXXXXXXXXXXXXXXXXXXXXGOOAAXXXXXXXXXXXXXXXXXGOOOAAXXXXXXXXXXXXXXXXGXAAAOXXXXXXXXXXXXXXXXGOOXXXXXXXXXXXXXXXXXXXGAXXXXXXXXXXXXXXXXXXXXGAXXXXXXXXXXXXXXXXXXXX,0,497,103

13230,42,12,30,194,260,0,0,394,317,77,GOAAXXXXXXXXXXXXXXXXXXGOOOXXXXXXXXXXXXXXXXXXGXXXXXXXXXXXXXXXXXXXXXGOXXXXXXXXXXXXXXXXXXXXGXOOAXXXXXXXXXXXXXXXXXGOXXXXXXXXXXXXXXXXXXXXGOXXXXXXXXXXXXXXXXXXXXGOOAAXXXXXXXXXXXXXXXXXGOOOAAXXXXXXXXXXXXXXXXGXAAAOXXXXXXXXXXXXXXXXGOOXXXXXXXXXXXXXXXXXXXGAXXXXXXXXXXXXXXXXXXXXGAXXXXXXXXXXXXXXXXXXXX,0,496,104
13251,42,12,30,194,260,0,0,394,314,80,GOAAXXXXXXXXXXXXXXXXXXGOOOXXXXXXXXXXXXXXXXXXGXXXXXXXXXXXXXXXXXXXXXGOXXXXXXXXXXXXXXXXXXXXGXOOAXXXXXXXXXXXXXXXXXGOXXXXXXXXXXXXXXXXXXXXGOXXXXXXXXXXXXXXXXXXXXGOOAAXXXXXXXXXXXXXXXXXGOOOAAXXXXXXXXXXXXXXXXGXAAAOXXXXXXXXXXXXXXXXGOOXXXXXXXXXXXXXXXXXXXGAXXXXXXXXXXXXXXXXXXXXGAXXXXXXXXXXXXXXXXXXXX,0,496,104
13272,40,12,28,187,269,0,0,400,317,83,GOAAXXXXXXXXXXXXXXXXXXGOOOXXXXXXXXXXXXXXXXXXGXXXXXXXXXXXXXXXXXXXXXGOXXXXXXXXXXXXXXXXXXXXGXXXXXXXXXXXXXXXXXXXXXGOXXXXXXXXXXXXXXXXXXXXGOXXXXXXXXXXXXXXXXXXXXGOOAAXXXXXXXXXXXXXXXXXGOOOAAXXXXXXXXXXXXXXXXGXAAAOXXXXXXXXXXXXXXXXGOOXXXXXXXXXXXXXXXXXXXGAAXXXXXXXXXXXXXXXXXXXGAXXXXXXXXXXXXXXXXXXXX,0,496,104
13293,41,13,28,182,273,0,0,406,318,88,GOAAXXXXXXXXXXXXXXXXXXGOOOXXXXXXXXXXXXXXXXXXGXXXXXXXXXXXXXXXXXXXXXGOXXXXXXXXXXXXXXXXXXXXGXXXXXXXXXXXXXXXXXXXXXGOXXXXXXXXXXXXXXXXXXXXGOXXXXXXXXXXXXXXXXXXXXGOOAAXXXXXXXXXXXXXXXXXGOOOAAAXXXXXXXXXXXXXXXGXAAAOXXXXXXXXXXXXXXXXGOOXXXXXXXXXXXXXXXXXXXGAAXXXXXXXXXXXXXXXXXXXGAXXXXXXXXXXXXXXXXXXXX,0,496,104
13314,41,13,28,187,268,0,0,400,314,86,GOAAXXXXXXXXXXXXXXXXXXGOOOXXXXXXXXXXXXXXXXXXGXXXXXXXXXXXXXXXXXXXXXGOXXXXXXXXXXXXXXXXXXXXGXXXXXXXXXXXXXXXXXXXXXGOXXXXXXXXXXXXXXXXXXXXGOXXXXXXXXXXXXXXXXXXXXGOOAAXXXXXXXXXXXXXXXXXGOOOAAAXXXXXXXXXXXXXXXGXAAAOXXXXXXXXXXXXXXXXGOOXXXXXXXXXXXXXXXXXXXGAAXXXXXXXXXXXXXXXXXXXGAXXXXXXXXXXXXXXXXXXXX,0,496,104

13335,43,15,28,184,269,0,0,402,314,88,GOAAXXXXXXXXXXXXXXXXXXGOOOAAXXXXXXXXXXXXXXXXGXXXXXXXXXXXXXXXXXXXXXGOXXXXXXXXXXXXXXXXXXXXGXXXXXXXXXXXXXXXXXXXXXGOXXXXXXXXXXXXXXXXXXXXGOXXXXXXXXXXXXXXXXXXXXGOOAAXXXXXXXXXXXXXXXXXGOOOAAAXXXXXXXXXXXXXXXGXAAAOXXXXXXXXXXXXXXXXGOOXXXXXXXXXXXXXXXXXXXGAAXXXXXXXXXXXXXXXXXXXGAXXXXXXXXXXXXXXXXXXXX,0,496,104
13356,44,16,28,185,267,0,0,400,313,87,GOAAXXXXXXXXXXXXXXXXXXGOOOAAXXXXXXXXXXXXXXXXGXXXXXXXXXXXXXXXXXXXXXGOAXXXXXXXXXXXXXXXXXXXGXXXXXXXXXXXXXXXXXXXXXGOXXXXXXXXXXXXXXXXXXXXGOXXXXXXXXXXXXXXXXXXXXGOOAAXXXXXXXXXXXXXXXXXGOOOAAAXXXXXXXXXXXXXXXGXAAAOXXXXXXXXXXXXXXXXGOOXXXXXXXXXXXXXXXXXXXGAAXXXXXXXXXXXXXXXXXXXGAXXXXXXXXXXXXXXXXXXXX,0,496,104
13377,44,15,29,184,267,0,0,402,313,89,GOAAXXXXXXXXXXXXXXXXXXGOOOAAOXXXXXXXXXXXXXXXGXXXXXXXXXXXXXXXXXXXXXGOAXXXXXXXXXXXXXXXXXXXGXXXXXXXXXXXXXXXXXXXXXGOXXXXXXXXXXXXXXXXXXXXGOXXXXXXXXXXXXXXXXXXXXGOOAAXXXXXXXXXXXXXXXXXGOOXAAOXXXXXXXXXXXXXXXGXAAAOXXXXXXXXXXXXXXXXGOOXXXXXXXXXXXXXXXXXXXGAAXXXXXXXXXXXXXXXXXXXGAXXXXXXXXXXXXXXXXXXXX,0,495,105
13398,44,14,30,183,268,0,0,404,313,91,GOAAXXXXXXXXXXXXXXXXXXGOOOAAOXXXXXXXXXXXXXXXGXXXXXXXXXXXXXXXXXXXXXGOAXXXXXXXXXXXXXXXXXXXGXXXXXXXXXXXXXXXXXXXXXGOXXXXXXXXXXXXXXXXXXXXGOXXXXXXXXXXXXXXXXXXXXGOOAOXXXXXXXXXXXXXXXXXGOOXAAOXXXXXXXXXXXXXXXGXAAAOXXXXXXXXXXXXXXXXGOOXXXXXXXXXXXXXXXXXXXGAAXXXXXXXXXXXXXXXXXXXGAXXXXXXXXXXXXXXXXXXXX,0,495,105
13419,44,14,30,185,266,0,0,401,309,92,GOAAXXXXXXXXXXXXXXXXXXGOOOAAOXXXXXXXXXXXXXXXGXXXXXXXXXXXXXXXXXXXXXGOAXXXXXXXXXXXXXXXXXXXGXXXXXXXXXXXXXXXXXXXXXGOXXXXXXXXXXXXXXXXXXXXGOXXXXXXXXXXXXXXXXXXXXGOOAOXXXXXXXXXXXXXXXXXGOOXAAOXXXXXXXXXXXXXXXGXAAAOXXXXXXXXXXXXXXXXGOOXXXXXXXXXXXXXXXXXXXGAAXXXXXXXXXXXXXXXXXXXGAXXXXXXXXXXXXXXXXXXXX,0,495,105

13440,44,13,31,186,265,0,0,402,305,97,GOAAXXXXXXXXXXXXXXXXXXGOOOAAOXXXXXXXXXXXXXXXGXXXXXXXXXXXXXXXXXXXXXGOAXXXXXXXXXXXXXXXXXXXGXXXXXXXXXXXXXXXXXXXXXGOXXXXXXXXXXXXXXXXXXXXGOXXXXXXXXXXXXXXXXXXXXGOOAOXXXXXXXXXXXXXXXXXGOOXAAOXXXXXXXXXXXXXXXGXAAAOXXXXXXXXXXXXXXXXGOOXXXXXXXXXXXXXXXXXXXGAAXXXXXXXXXXXXXXXXXXXGOXXXXXXXXXXXXXXXXXXXX,0,495,105
13461,45,15,30,186,263,0,0,400,311,89,GXAAXXXXXXXXXXXXXXXXXXGOOOAAOAXXXXXXXXXXXXXXGXXXXXXXXXXXXXXXXXXXXXGOAXXXXXXXXXXXXXXXXXXXGXXXXXXXXXXXXXXXXXXXXXGOXXXXXXXXXXXXXXXXXXXXGOXXXXXXXXXXXXXXXXXXXXGOOAOXXXXXXXXXXXXXXXXXGOOXAAOAXXXXXXXXXXXXXXGXAAAOXXXXXXXXXXXXXXXXGOOXXXXXXXXXXXXXXXXXXXGAAXXXXXXXXXXXXXXXXXXXGOXXXXXXXXXXXXXXXXXXXX,0,494,106
13482,47,16,31,178,269,0,0,407,313,94,GXAAXXXXXXXXXXXXXXXXXXGOOOAAOAAXXXXXXXXXXXXXGXXXXXXXXXXXXXXXXXXXXXGOAXXXXXXXXXXXXXXXXXXXGXXXXXXXXXXXXXXXXXXXXXGOXXXXXXXXXXXXXXXXXXXXGOXXXXXXXXXXXXXXXXXXXXGOOAOAXXXXXXXXXXXXXXXXGOOXAAOAXXXXXXXXXXXXXXGXAAOOXXXXXXXXXXXXXXXXGOOXXXXXXXXXXXXXXXXXXXGAAXXXXXXXXXXXXXXXXXXXGOXXXXXXXXXXXXXXXXXXXX,0,494,106
13503,47,16,31,177,270,0,0,408,314,94,GXAAXXXXXXXXXXXXXXXXXXGOOOAAOAAXXXXXXXXXXXXXGXXXXXXXXXXXXXXXXXXXXXGOAXXXXXXXXXXXXXXXXXXXGXXXXXXXXXXXXXXXXXXXXXGOXXXXXXXXXXXXXXXXXXXXGOXXXXXXXXXXXXXXXXXXXXGOOAOAXXXXXXXXXXXXXXXXGOOXAAOAXXXXXXXXXXXXXXGXAAOOXXXXXXXXXXXXXXXXGOOXXXXXXXXXXXXXXXXXXXGAAXXXXXXXXXXXXXXXXXXXGOXXXXXXXXXXXXXXXXXXXX,0,494,106
13524,48,17,31,180,266,0,0,404,316,88,GXAAAXXXXXXXXXXXXXXXXXGOOOAAOAAXXXXXXXXXXXXXGXXXXXXXXXXXXXXXXXXXXXGOAXXXXXXXXXXXXXXXXXXXGXXXXXXXXXXXXXXXXXXXXXGOXXXXXXXXXXXXXXXXXXXXGOXXXXXXXXXXXXXXXXXXXXGOOAOAXXXXXXXXXXXXXXXXGOOXAAOAXXXXXXXXXXXXXXGXAAOOXXXXXXXXXXXXXXXXGOOXXXXXXXXXXXXXXXXXXXGAAXXXXXXXXXXXXXXXXXXXGOXXXXXXXXXXXXXXXXXXXX,0,494,106

13545,49,18,31,180,265,0,0,403,320,83,GXAAAXXXXXXXXXXXXXXXXXGOOOAAOAAAXXXXXXXXXXXXGXXXXXXXXXXXXXXXXXXXXXGOAXXXXXXXXXXXXXXXXXXXGXXXXXXXXXXXXXXXXXXXXXGOXXXXXXXXXXXXXXXXXXXXGOXXXXXXXXXXXXXXXXXXXXGOOAOAXXXXXXXXXXXXXXXXGOOXAAOAXXXXXXXXXXXXXXGXAAOOXXXXXXXXXXXXXXXXGOOXXXXXXXXXXXXXXXXXXXGAAXXXXXXXXXXXXXXXXXXXGOXXXXXXXXXXXXXXXXXXXX,0,494,106
13566,49,18,31,179,266,0,0,405,319,86,GXAAAXXXXXXXXXXXXXXXXXGOOOAAOAAAXXXXXXXXXXXXGXXXXXXXXXXXXXXXXXXXXXGOAXXXXXXXXXXXXXXXXXXXGXXXXXXXXXXXXXXXXXXXXXGOXXXXXXXXXXXXXXXXXXXXGOXXXXXXXXXXXXXXXXXXXXGOOAOAXXXXXXXXXXXXXXXXGOOXAAOAXXXXXXXXXXXXXXGXAAOOXXXXXXXXXXXXXXXXGOOXXXXXXXXXXXXXXXXXXXGAAXXXXXXXXXXXXXXXXXXXGOXXXXXXXXXXXXXXXXXXXX,0,494,106
13587,50,18,32,178,266,0,0,406,321,85,GXAAAXXXXXXXXXXXXXXXXXGOOOAAOAAAXXXXXXXXXXXXGXXXXXXXXXXXXXXXXXXXXXGOAXXXXXXXXXXXXXXXXXXXGXXXXXXXXXXXXXXXXXXXXXGOXXXXXXXXXXXXXXXXXXXXGOXXXXXXXXXXXXXXXXXXXXGOOAOAXXXXXXXXXXXXXXXXGOOAAAOOXXXXXXXXXXXXXXGXAAOOXXXXXXXXXXXXXXXXGOOXXXXXXXXXXXXXXXXXXXGAAXXXXXXXXXXXXXXXXXXXGOXXXXXXXXXXXXXXXXXXXX,0,494,106
13608,52,20,32,177,265,0,0,405,321,84,GXAAAXXXXXXXXXXXXXXXXXGOOOAAOAAAXXXXXXXXXXXXGXXXXXXXXXXXXXXXXXXXXXGOAXXXXXXXXXXXXXXXXXXXGXXXXXXXXXXXXXXXXXXXXXGOXXXXXXXXXXXXXXXXXXXXGOXXXXXXXXXXXXXXXXXXXXGOOAOAXXXXXXXXXXXXXXXXGOOAAAOOXXXXXXXXXXXXXXGXAAOOXXXXXXXXXXXXXXXXGOOAXXXXXXXXXXXXXXXXXXGAAXXXXXXXXXXXXXXXXXXXGOAXXXXXXXXXXXXXXXXXXX,0,494,106
13629,52,20,32,172,270,0,0,410,321,89,GXAAAXXXXXXXXXXXXXXXXXGOOOAAOAAAXXXXXXXXXXXXGXXXXXXXXXXXXXXXXXXXXXGOAXXXXXXXXXXXXXXXXXXXGXXXXXXXXXXXXXXXXXXXXXGOXXXXXXXXXXXXXXXXXXXXGOXXXXXXXXXXXXXXXXXXXXGOOAOAXXXXXXXXXXXXXXXXGOOAAAOOXXXXXXXXXXXXXXGXAAOOXXXXXXXXXXXXXXXXGOOAXXXXXXXXXXXXXXXXXXGAAXXXXXXXXXXXXXXXXXXXGOAXXXXXXXXXXXXXXXXXXX,0,494,106

13650,52,19,33,168,274,0,0,415,325,90,GXAAAXXXXXXXXXXXXXXXXXGOOOOAOAAAXXXXXXXXXXXXGXXXXXXXXXXXXXXXXXXXXXGOAXXXXXXXXXXXXXXXXXXXGXXXXXXXXXXXXXXXXXXXXXGOXXXXXXXXXXXXXXXXXXXXGOXXXXXXXXXXXXXXXXXXXXGOOAOAXXXXXXXXXXXXXXXXGOOAAAOOXXXXXXXXXXXXXXGXAAOOXXXXXXXXXXXXXXXXGOOAXXXXXXXXXXXXXXXXXXGAAXXXXXXXXXXXXXXXXXXXGOAXXXXXXXXXXXXXXXXXXX,0,494,106
13671,53,20,33,165,276,0,0,417,320,97,GXAAAXXXXXXXXXXXXXXXXXGOOOOAOAAAXXXXXXXXXXXXGXXXXXXXXXXXXXXXXXXXXXGOAAXXXXXXXXXXXXXXXXXXGXXXXXXXXXXXXXXXXXXXXXGOXXXXXXXXXXXXXXXXXXXXGOXXXXXXXXXXXXXXXXXXXXGOOAOAXXXXXXXXXXXXXXXXGOOAAAOOXXXXXXXXXXXXXXGXAAOOXXXXXXXXXXXXXXXXGOOAXXXXXXXXXXXXXXXXXXGAAXXXXXXXXXXXXXXXXXXXGOAXXXXXXXXXXXXXXXXXXX,0,494,106
13692,53,20,33,165,276,0,0,416,321,95,GXAAAXXXXXXXXXXXXXXXXXGOOOOAOAAAXXXXXXXXXXXXGXXXXXXXXXXXXXXXXXXXXXGOAAXXXXXXXXXXXXXXXXXXGXXXXXXXXXXXXXXXXXXXXXGOXXXXXXXXXXXXXXXXXXXXGOXXXXXXXXXXXXXXXXXXXXGOOAOAXXXXXXXXXXXXXXXXGOOAAAOOXXXXXXXXXXXXXXGXAAOOXXXXXXXXXXXXXXXXGOOAXXXXXXXXXXXXXXXXXXGAAXXXXXXXXXXXXXXXXXXXGOAXXXXXXXXXXXXXXXXXXX,0,494,106
13713,53,20,33,164,277,0,0,418,319,99,GXAAAXXXXXXXXXXXXXXXXXGOOOOAOAAAXXXXXXXXXXXXGXXXXXXXXXXXXXXXXXXXXXGOAAXXXXXXXXXXXXXXXXXXGXXXXXXXXXXXXXXXXXXXXXGOXXXXXXXXXXXXXXXXXXXXGOXXXXXXXXXXXXXXXXXXXXGOOAOAXXXXXXXXXXXXXXXXGOOAAAOOXXXXXXXXXXXXXXGXAAOOXXXXXXXXXXXXXXXXGOOAXXXXXXXXXXXXXXXXXXGAAXXXXXXXXXXXXXXXXXXXGOAXXXXXXXXXXXXXXXXXXX,0,494,106
13734,54,21,33,162,278,0,0,419,323,96,GXAAAXXXXXXXXXXXXXXXXXGOOOOAOAAAAXXXXXXXXXXXGXXXXXXXXXXXXXXXXXXXXXGOAAXXXXXXXXXXXXXXXXXXGXXXXXXXXXXXXXXXXXXXXXGOXXXXXXXXXXXXXXXXXXXXGOXXXXXXXXXXXXXXXXXXXXGOOAOAXXXXXXXXXXXXXXXXGOOAAAOOXXXXXXXXXXXXXXGXAAOOXXXXXXXXXXXXXXXXGOOAXXXXXXXXXXXXXXXXXXGAAXXXXXXXXXXXXXXXXXXXGOAXXXXXXXXXXXXXXXXXXX,0,494,106

13755,54,21,33,169,271,0,0,411,318,93,GXAAAXXXXXXXXXXXXXXXXXGOOOOAOAAAAXXXXXXXXXXXGXXXXXXXXXXXXXXXXXXXXXGOAAXXXXXXXXXXXXXXXXXXGXXXXXXXXXXXXXXXXXXXXXGOXXXXXXXXXXXXXXXXXXXXGOXXXXXXXXXXXXXXXXXXXXGOOAOAXXXXXXXXXXXXXXXXGOOAAAOOXXXXXXXXXXXXXXGXAAOOXXXXXXXXXXXXXXXXGOOAXXXXXXXXXXXXXXXXXXGAAXXXXXXXXXXXXXXXXXXXGOAXXXXXXXXXXXXXXXXXXX,0,494,106
13776,54,21,33,173,267,0,0,407,316,91,GXAAAXXXXXXXXXXXXXXXXXGOOOOAOAAAAXXXXXXXXXXXGXXXXXXXXXXXXXXXXXXXXXGOAAXXXXXXXXXXXXXXXXXXGXXXXXXXXXXXXXXXXXXXXXGOXXXXXXXXXXXXXXXXXXXXGOXXXXXXXXXXXXXXXXXXXXGOOAOAXXXXXXXXXXXXXXXXGOOAAAOOXXXXXXXXXXXXXXGXAAOOXXXXXXXXXXXXXXXXGOOAXXXXXXXXXXXXXXXXXXGAAXXXXXXXXXXXXXXXXXXXGOAXXXXXXXXXXXXXXXXXXX,0,494,106
13797,54,20,34,177,262,0,0,406,313,93,GXAAAXXXXXXXXXXXXXXXXXGOOOOAOAAAAXXXXXXXXXXXGXXXXXXXXXXXXXXXXXXXXXGAOAXXXXXXXXXXXXXXXXXXGXXXXXXXXXXXXXXXXXXXXXGOXXXXXXXXXXXXXXXXXXXXGOXXXXXXXXXXXXXXXXXXXXGOOAOAXXXXXXXXXXXXXXXXGOOAAAOOXXXXXXXXXXXXXXGXAOOOXXXXXXXXXXXXXXXXGOOAXXXXXXXXXXXXXXXXXXGAAXXXXXXXXXXXXXXXXXXXGOAXXXXXXXXXXXXXXXXXXX,0,493,107
13818,52,19,33,176,265,0,0,407,316,91,GXAAAXXXXXXXXXXXXXXXXXGOOOOAOAAAAXXXXXXXXXXXGXXXXXXXXXXXXXXXXXXXXXGAXXXXXXXXXXXXXXXXXXXXGXXXXXXXXXXXXXXXXXXXXXGOXXXXXXXXXXXXXXXXXXXXGOXXXXXXXXXXXXXXXXXXXXGOOAOAXXXXXXXXXXXXXXXXGOOAAAOOXXXXXXXXXXXXXXGXAOOOXXXXXXXXXXXXXXXXGOOAXXXXXXXXXXXXXXXXXXGAAXXXXXXXXXXXXXXXXXXXGOAXXXXXXXXXXXXXXXXXXX,0,493,107
13839,53,18,35,173,267,0,0,411,316,95,GXOAAXXXXXXXXXXXXXXXXXGOOOOAOAAAOXXXXXXXXXXXGXXXXXXXXXXXXXXXXXXXXXGAXXXXXXXXXXXXXXXXXXXXGXXXXXXXXXXXXXXXXXXXXXGOXXXXXXXXXXXXXXXXXXXXGOXXXXXXXXXXXXXXXXXXXXGOOAOAXXXXXXXXXXXXXXXXGOOAAAOOXXXXXXXXXXXXXXGXAOOOXXXXXXXXXXXXXXXXGOOAXXXXXXXXXXXXXXXXXXGAAAXXXXXXXXXXXXXXXXXXGOAXXXXXXXXXXXXXXXXXXX,0,493,107

13860,53,18,35,176,264,0,0,408,314,94,GXOAAXXXXXXXXXXXXXXXXXGOOOOAOAAAOXXXXXXXXXXXGXXXXXXXXXXXXXXXXXXXXXGAXXXXXXXXXXXXXXXXXXXXGXXXXXXXXXXXXXXXXXXXXXGOXXXXXXXXXXXXXXXXXXXXGOXXXXXXXXXXXXXXXXXXXXGOOAOAXXXXXXXXXXXXXXXXGOOAAAOOXXXXXXXXXXXXXXGXAOOOXXXXXXXXXXXXXXXXGOOAXXXXXXXXXXXXXXXXXXGAAAXXXXXXXXXXXXXXXXXXGOAXXXXXXXXXXXXXXXXXXX,0,493,107
13881,54,19,35,179,260,0,0,404,316,88,GXOAAAXXXXXXXXXXXXXXXXGOOOOAOAAAOXXXXXXXXXXXGXXXXXXXXXXXXXXXXXXXXXGAXXXXXXXXXXXXXXXXXXXXGXXXXXXXXXXXXXXXXXXXXXGOXXXXXXXXXXXXXXXXXXXXGOXXXXXXXXXXXXXXXXXXXXGOOAOAXXXXXXXXXXXXXXXXGOOAAAOOXXXXXXXXXXXXXXGXAOOOXXXXXXXXXXXXXXXXGOOAXXXXXXXXXXXXXXXXXXGAAAXXXXXXXXXXXXXXXXXXGOAXXXXXXXXXXXXXXXXXXX,0,493,107
13902,53,18,35,177,262,0,0,407,319,88,GXOAAAXXXXXXXXXXXXXXXXGOOOOAOOAAOXXXXXXXXXXXGXXXXXXXXXXXXXXXXXXXXXGAXXXXXXXXXXXXXXXXXXXXGXXXXXXXXXXXXXXXXXXXXXGOXXXXXXXXXXXXXXXXXXXXGOXXXXXXXXXXXXXXXXXXXXGOOAOAXXXXXXXXXXXXXXXXGXOAAAOOXXXXXXXXXXXXXXGXAOOOXXXXXXXXXXXXXXXXGOOAXXXXXXXXXXXXXXXXXXGAAAXXXXXXXXXXXXXXXXXXGOAXXXXXXXXXXXXXXXXXXX,0,492,108
13923,53,17,36,185,254,0,0,401,316,85,GXOAAAXXXXXXXXXXXXXXXXGOOOOAOOAAOXXXXXXXXXXXGXXXXXXXXXXXXXXXXXXXXXGAXXXXXXXXXXXXXXXXXXXXGXXXXXXXXXXXXXXXXXXXXXGOXXXXXXXXXXXXXXXXXXXXGOXXXXXXXXXXXXXXXXXXXXGOOOOAXXXXXXXXXXXXXXXXGXOAAAOOXXXXXXXXXXXXXXGXAOOOXXXXXXXXXXXXXXXXGOOAXXXXXXXXXXXXXXXXXXGAAAXXXXXXXXXXXXXXXXXXGOAXXXXXXXXXXXXXXXXXXX,0,492,108
13944,53,16,37,185,254,0,0,402,317,85,GXOAAAXXXXXXXXXXXXXXXXGOOOOAOOOAOXXXXXXXXXXXGXXXXXXXXXXXXXXXXXXXXXGAXXXXXXXXXXXXXXXXXXXXGXXXXXXXXXXXXXXXXXXXXXGOXXXXXXXXXXXXXXXXXXXXGOXXXXXXXXXXXXXXXXXXXXGOOOOAXXXXXXXXXXXXXXXXGXOAAAOOXXXXXXXXXXXXXXGXAOOOXXXXXXXXXXXXXXXXGOOAXXXXXXXXXXXXXXXXXXGAAAXXXXXXXXXXXXXXXXXXGOAXXXXXXXXXXXXXXXXXXX,0,492,108

13965,54,17,37,180,258,0,0,406,322,84,GAOAAAXXXXXXXXXXXXXXXXGOOOOAOOOAOXXXXXXXXXXXGXXXXXXXXXXXXXXXXXXXXXGAXXXXXXXXXXXXXXXXXXXXGXXXXXXXXXXXXXXXXXXXXXGOXXXXXXXXXXXXXXXXXXXXGOXXXXXXXXXXXXXXXXXXXXGOOOOAXXXXXXXXXXXXXXXXGXOAAAOOXXXXXXXXXXXXXXGXAOOOXXXXXXXXXXXXXXXXGOOAXXXXXXXXXXXXXXXXXXGAAAXXXXXXXXXXXXXXXXXXGOAXXXXXXXXXXXXXXXXXXX,0,492,108
13986,54,17,37,180,258,0,0,407,323,84,GAOAAAXXXXXXXXXXXXXXXXGOOOOAOOOAOXXXXXXXXXXXGXXXXXXXXXXXXXXXXXXXXXGAXXXXXXXXXXXXXXXXXXXXGXXXXXXXXXXXXXXXXXXXXXGOXXXXXXXXXXXXXXXXXXXXGOXXXXXXXXXXXXXXXXXXXXGOOOOAXXXXXXXXXXXXXXXXGXOAAAOOXXXXXXXXXXXXXXGXAOOOXXXXXXXXXXXXXXXXGOOAXXXXXXXXXXXXXXXXXXGAAAXXXXXXXXXXXXXXXXXXGOAXXXXXXXXXXXXXXXXXXX,0,492,108
14007,54,16,38,181,257,0,0,407,322,85,GAOAAAXXXXXXXXXXXXXXXXGOOOOAOOOAOXXXXXXXXXXXGXXXXXXXXXXXXXXXXXXXXXGAXXXXXXXXXXXXXXXXXXXXGXXXXXXXXXXXXXXXXXXXXXGOXXXXXXXXXXXXXXXXXXXXGOXXXXXXXXXXXXXXXXXXXXGOOOOAXXXXXXXXXXXXXXXXGXOAAAOOXXXXXXXXXXXXXXGXOOOOXXXXXXXXXXXXXXXXGOOAXXXXXXXXXXXXXXXXXXGAAAXXXXXXXXXXXXXXXXXXGOAXXXXXXXXXXXXXXXXXXX,0,492,108
14028,52,15,37,184,254,0,0,405,322,83,GAOAAAXXXXXXXXXXXXXXXXGOOOOAOOOAOXXXXXXXXXXXGXXXXXXXXXXXXXXXXXXXXXGAXXXXXXXXXXXXXXXXXXXXGXXXXXXXXXXXXXXXXXXXXXGXXXXXXXXXXXXXXXXXXXXXGOXXXXXXXXXXXXXXXXXXXXGOOOOAXXXXXXXXXXXXXXXXGXOAAAOOXXXXXXXXXXXXXXGXOOOOXXXXXXXXXXXXXXXXGOOAXXXXXXXXXXXXXXXXXXGAOAXXXXXXXXXXXXXXXXXXGXAXXXXXXXXXXXXXXXXXXX,0,490,110
14049,52,15,37,183,255,0,0,404,324,80,GAOAAAXXXXXXXXXXXXXXXXGOOOOAOOOAOXXXXXXXXXXXGXXXXXXXXXXXXXXXXXXXXXGAXXXXXXXXXXXXXXXXXXXXGXXXXXXXXXXXXXXXXXXXXXGXXXXXXXXXXXXXXXXXXXXXGOXXXXXXXXXXXXXXXXXXXXGOOOOAXXXXXXXXXXXXXXXXGXOAAAOOXXXXXXXXXXXXXXGXOOOOXXXXXXXXXXXXXXXXGOOAXXXXXXXXXXXXXXXXXXGAOAXXXXXXXXXXXXXXXXXXGXAXXXXXXXXXXXXXXXXXXX,0,490,110

14070,51,15,36,185,253,0,0,404,326,78,GAOAAAXXXXXXXXXXXXXXXXGOOOOAOOOAOXXXXXXXXXXXGXXXXXXXXXXXXXXXXXXXXXGAXXXXXXXXXXXXXXXXXXXXGXXXXXXXXXXXXXXXXXXXXXGXXXXXXXXXXXXXXXXXXXXXGOXXXXXXXXXXXXXXXXXXXXGOOOOAXXXXXXXXXXXXXXXXGXOAAAOOXXXXXXXXXXXXXXGXOOXOXXXXXXXXXXXXXXXXGOOAXXXXXXXXXXXXXXXXXXGAOAXXXXXXXXXXXXXXXXXXGXAXXXXXXXXXXXXXXXXXXX,0,489,111
14091,54,17,37,178,257,0,0,406,320,86,GAOAAAXXXXXXXXXXXXXXXXGOOOOAOOOAOAAXXXXXXXXXGXXXXXXXXXXXXXXXXXXXXXGAXXXXXXXXXXXXXXXXXXXXGXXXXXXXXXXXXXXXXXXXXXGAXXXXXXXXXXXXXXXXXXXXGOXXXXXXXXXXXXXXXXXXXXGOOOOAXXXXXXXXXXXXXXXXGXOAAAOOXXXXXXXXXXXXXXGXOOXOXXXXXXXXXXXXXXXXGOOAXXXXXXXXXXXXXXXXXXGOOAXXXXXXXXXXXXXXXXXXGXAXXXXXXXXXXXXXXXXXXX,0,489,111
14112,54,17,37,177,258,0,0,408,316,92,GAOAAAXXXXXXXXXXXXXXXXGOOOOAOOOAOAAXXXXXXXXXGXXXXXXXXXXXXXXXXXXXXXGAXXXXXXXXXXXXXXXXXXXXGXXXXXXXXXXXXXXXXXXXXXGAXXXXXXXXXXXXXXXXXXXXGOXXXXXXXXXXXXXXXXXXXXGOOOOAXXXXXXXXXXXXXXXXGXOAAAOOXXXXXXXXXXXXXXGXOOXOXXXXXXXXXXXXXXXXGOOAXXXXXXXXXXXXXXXXXXGOOAXXXXXXXXXXXXXXXXXXGXAXXXXXXXXXXXXXXXXXXX,0,489,111
14133,54,17,37,180,255,0,0,405,320,85,GAOAAAXXXXXXXXXXXXXXXXGOOOOAOOOAOAAXXXXXXXXXGXXXXXXXXXXXXXXXXXXXXXGAXXXXXXXXXXXXXXXXXXXXGXXXXXXXXXXXXXXXXXXXXXGAXXXXXXXXXXXXXXXXXXXXGOXXXXXXXXXXXXXXXXXXXXGOOOOAXXXXXXXXXXXXXXXXGXOAAAOOXXXXXXXXXXXXXXGXOOXOXXXXXXXXXXXXXXXXGOOAXXXXXXXXXXXXXXXXXXGOOAXXXXXXXXXXXXXXXXXXGXAXXXXXXXXXXXXXXXXXXX,0,489,111
14154,53,16,37,175,260,0,0,411,321,90,GAOAAAXXXXXXXXXXXXXXXXGOOOXAOOOAOAAXXXXXXXXXGXXXXXXXXXXXXXXXXXXXXXGAXXXXXXXXXXXXXXXXXXXXGXXXXXXXXXXXXXXXXXXXXXGAXXXXXXXXXXXXXXXXXXXXGOXXXXXXXXXXXXXXXXXXXXGOOOOAXXXXXXXXXXXXXXXXGXOOAAOOXXXXXXXXXXXXXXGXOOXOXXXXXXXXXXXXXXXXGOOAXXXXXXXXXXXXXXXXXXGOOAXXXXXXXXXXXXXXXXXXGXAXXXXXXXXXXXXXXXXXXX,0,488,112

14175,53,15,38,175,260,0,0,412,323,89,GAOAOAXXXXXXXXXXXXXXXXGOOOXAOOOAOAAXXXXXXXXXGXXXXXXXXXXXXXXXXXXXXXGAXXXXXXXXXXXXXXXXXXXXGXXXXXXXXXXXXXXXXXXXXXGAXXXXXXXXXXXXXXXXXXXXGOXXXXXXXXXXXXXXXXXXXXGOOOOAXXXXXXXXXXXXXXXXGXOOAAOOXXXXXXXXXXXXXXGXOOXOXXXXXXXXXXXXXXXXGOOAXXXXXXXXXXXXXXXXXXGOOAXXXXXXXXXXXXXXXXXXGXAXXXXXXXXXXXXXXXXXXX,0,488,112
14196,53,15,38,180,255,0,0,407,321,86,GAOAOAXXXXXXXXXXXXXXXXGOOOXAOOOAOAAXXXXXXXXXGXXXXXXXXXXXXXXXXXXXXXGAXXXXXXXXXXXXXXXXXXXXGXXXXXXXXXXXXXXXXXXXXXGAXXXXXXXXXXXXXXXXXXXXGOXXXXXXXXXXXXXXXXXXXXGOOOOAXXXXXXXXXXXXXXXXGXOOAAOOXXXXXXXXXXXXXXGXOOXOXXXXXXXXXXXXXXXXGOOAXXXXXXXXXXXXXXXXXXGOOAXXXXXXXXXXXXXXXXXXGXAXXXXXXXXXXXXXXXXXXX,0,488,112
14217,53,15,38,180,255,0,0,407,319,88,GAOAOAXXXXXXXXXXXXXXXXGOOOXAOOOAOAAXXXXXXXXXGXXXXXXXXXXXXXXXXXXXXXGAXXXXXXXXXXXXXXXXXXXXGXXXXXXXXXXXXXXXXXXXXXGAXXXXXXXXXXXXXXXXXXXXGOXXXXXXXXXXXXXXXXXXXXGOOOOAXXXXXXXXXXXXXXXXGXOOAAOOXXXXXXXXXXXXXXGXOOXOXXXXXXXXXXXXXXXXGOOAXXXXXXXXXXXXXXXXXXGOOAXXXXXXXXXXXXXXXXXXGXAXXXXXXXXXXXXXXXXXXX,0,488,112
14238,54,15,39,178,256,0,0,409,321,88,GAOAOAXXXXXXXXXXXXXXXXGOOOXAOOOAOAAXXXXXXXXXGXXXXXXXXXXXXXXXXXXXXXGAXXXXXXXXXXXXXXXXXXXXGXXXXXXXXXXXXXXXXXXXXXGAXXXXXXXXXXXXXXXXXXXXGOXXXXXXXXXXXXXXXXXXXXGOOOOAAXXXXXXXXXXXXXXXGXOOAAOOXXXXXXXXXXXXXXGXOOXOXXXXXXXXXXXXXXXXGOOOXXXXXXXXXXXXXXXXXXGOOAXXXXXXXXXXXXXXXXXXGXAXXXXXXXXXXXXXXXXXXX,0,488,112
14259,54,15,39,178,256,0,0,408,319,89,GAOAOAXXXXXXXXXXXXXXXXGOOOXAOOOAOAAXXXXXXXXXGXXXXXXXXXXXXXXXXXXXXXGAXXXXXXXXXXXXXXXXXXXXGXXXXXXXXXXXXXXXXXXXXXGAXXXXXXXXXXXXXXXXXXXXGOXXXXXXXXXXXXXXXXXXXXGOOOOAAXXXXXXXXXXXXXXXGXOOAAOOXXXXXXXXXXXXXXGXOOXOXXXXXXXXXXXXXXXXGOOOXXXXXXXXXXXXXXXXXXGOOAXXXXXXXXXXXXXXXXXXGXAXXXXXXXXXXXXXXXXXXX,0,488,112

14280,54,14,40,178,256,0,0,409,322,87,GAOAOAXXXXXXXXXXXXXXXXGOOOXAOOOAOAAXXXXXXXXXGXXXXXXXXXXXXXXXXXXXXXGAXXXXXXXXXXXXXXXXXXXXGXXXXXXXXXXXXXXXXXXXXXGAXXXXXXXXXXXXXXXXXXXXGOXXXXXXXXXXXXXXXXXXXXGOOOOOAXXXXXXXXXXXXXXXGXOOAAOOXXXXXXXXXXXXXXGXOOXOXXXXXXXXXXXXXXXXGOOOXXXXXXXXXXXXXXXXXXGOOAXXXXXXXXXXXXXXXXXXGXAXXXXXXXXXXXXXXXXXXX,0,488,112
14301,54,14,40,182,252,0,0,405,320,85,GAOAOAXXXXXXXXXXXXXXXXGOOOXAOOOAOAAXXXXXXXXXGXXXXXXXXXXXXXXXXXXXXXGAXXXXXXXXXXXXXXXXXXXXGXXXXXXXXXXXXXXXXXXXXXGAXXXXXXXXXXXXXXXXXXXXGOXXXXXXXXXXXXXXXXXXXXGOOOOOAXXXXXXXXXXXXXXXGXOOAAOOXXXXXXXXXXXXXXGXOOXOXXXXXXXXXXXXXXXXGOOOXXXXXXXXXXXXXXXXXXGOOAXXXXXXXXXXXXXXXXXXGXAXXXXXXXXXXXXXXXXXXX,0,488,112
14322,53,14,39,189,245,0,0,398,313,85,GAOAOAXXXXXXXXXXXXXXXXGOOOXAOOOAOAAXXXXXXXXXGXXXXXXXXXXXXXXXXXXXXXGAXXXXXXXXXXXXXXXXXXXXGXXXXXXXXXXXXXXXXXXXXXGAXXXXXXXXXXXXXXXXXXXXGOXXXXXXXXXXXXXXXXXXXXGOOOOOAXXXXXXXXXXXXXXXGXOOAAOOXXXXXXXXXXXXXXGXXOXOXXXXXXXXXXXXXXXXGOOOXXXXXXXXXXXXXXXXXXGOOAXXXXXXXXXXXXXXXXXXGXAXXXXXXXXXXXXXXXXXXX,0,487,113
14343,53,14,39,189,245,0,0,398,311,87,GAOAOAXXXXXXXXXXXXXXXXGOOOXAOOOAOAAXXXXXXXXXGXXXXXXXXXXXXXXXXXXXXXGAXXXXXXXXXXXXXXXXXXXXGXXXXXXXXXXXXXXXXXXXXXGAXXXXXXXXXXXXXXXXXXXXGOXXXXXXXXXXXXXXXXXXXXGOOOOOAXXXXXXXXXXXXXXXGXOOAAOOXXXXXXXXXXXXXXGXXOXOXXXXXXXXXXXXXXXXGOOOXXXXXXXXXXXXXXXXXXGOOAXXXXXXXXXXXXXXXXXXGXAXXXXXXXXXXXXXXXXXXX,0,487,113
14364,53,14,39,187,247,0,0,400,314,86,GAOAOAXXXXXXXXXXXXXXXXGOOOXAOOOAOAAXXXXXXXXXGXXXXXXXXXXXXXXXXXXXXXGAXXXXXXXXXXXXXXXXXXXXGXXXXXXXXXXXXXXXXXXXXXGAXXXXXXXXXXXXXXXXXXXXGOXXXXXXXXXXXXXXXXXXXXGOOOOOAXXXXXXXXXXXXXXXGXOOAAOOXXXXXXXXXXXXXXGXXOXOXXXXXXXXXXXXXXXXGOOOXXXXXXXXXXXXXXXXXXGOOAXXXXXXXXXXXXXXXXXXGXAXXXXXXXXXXXXXXXXXXX,0,487,113

14385,52,15,37,185,248,0,0,399,316,83,GAOAOAXXXXXXXXXXXXXXXXGOOOXAOOXAOAAXXXXXXXXXGXXXXXXXXXXXXXXXXXXXXXGAXXXXXXXXXXXXXXXXXXXXGXXXXXXXXXXXXXXXXXXXXXGAXXXXXXXXXXXXXXXXXXXXGAXXXXXXXXXXXXXXXXXXXXGOOOOOAXXXXXXXXXXXXXXXGXOOAAOOXXXXXXXXXXXXXXGXXOXOXXXXXXXXXXXXXXXXGOOOXXXXXXXXXXXXXXXXXXGOOAXXXXXXXXXXXXXXXXXXGXAXXXXXXXXXXXXXXXXXXX,0,485,115
14406,49,12,37,179,256,0,0,411,324,87,GAOAOOXXXXXXXXXXXXXXXXGOOOAAOOXXXXXXXXXXXXXXGXXXXXXXXXXXXXXXXXXXXXGAAXXXXXXXXXXXXXXXXXXXGXXXXXXXXXXXXXXXXXXXXXGAXXXXXXXXXXXXXXXXXXXXGAXXXXXXXXXXXXXXXXXXXXGOXOOOAXXXXXXXXXXXXXXXGXOOAAOOXXXXXXXXXXXXXXGXXOXOXXXXXXXXXXXXXXXXGOOOXXXXXXXXXXXXXXXXXXGOOOXXXXXXXXXXXXXXXXXXGXAXXXXXXXXXXXXXXXXXXX,0,484,116
14427,48,12,36,178,257,0,0,411,320,91,GAXAOOXXXXXXXXXXXXXXXXGOOOAAOOXXXXXXXXXXXXXXGXXXXXXXXXXXXXXXXXXXXXGAAXXXXXXXXXXXXXXXXXXXGXXXXXXXXXXXXXXXXXXXXXGAXXXXXXXXXXXXXXXXXXXXGAXXXXXXXXXXXXXXXXXXXXGOXOOOAXXXXXXXXXXXXXXXGXOOAAOOXXXXXXXXXXXXXXGXXOXOXXXXXXXXXXXXXXXXGOOOXXXXXXXXXXXXXXXXXXGOOOXXXXXXXXXXXXXXXXXXGXAXXXXXXXXXXXXXXXXXXX,0,483,117
14448,39,8,31,179,265,0,0,413,320,93,GAXAOOXXXXXXXXXXXXXXXXGOOOAOOOXXXXXXXXXXXXXXGXXXXXXXXXXXXXXXXXXXXXGAAXXXXXXXXXXXXXXXXXXXGXXXXXXXXXXXXXXXXXXXXXGAXXXXXXXXXXXXXXXXXXXXGAXXXXXXXXXXXXXXXXXXXXGOXXXXXXXXXXXXXXXXXXXXGXOOXXXXXXXXXXXXXXXXXXGXXOXXXXXXXXXXXXXXXXXXGOOOXXXXXXXXXXXXXXXXXXGOOOXXXXXXXXXXXXXXXXXXGXAXXXXXXXXXXXXXXXXXXX,0,483,117
14469,39,7,32,179,265,0,0,416,326,90,GAXOOOXXXXXXXXXXXXXXXXGOOOAOOOXXXXXXXXXXXXXXGXXXXXXXXXXXXXXXXXXXXXGAAXXXXXXXXXXXXXXXXXXXGXXXXXXXXXXXXXXXXXXXXXGAXXXXXXXXXXXXXXXXXXXXGAXXXXXXXXXXXXXXXXXXXXGOXXXXXXXXXXXXXXXXXXXXGXOOXXXXXXXXXXXXXXXXXXGXXOXXXXXXXXXXXXXXXXXXGOOOXXXXXXXXXXXXXXXXXXGOOOXXXXXXXXXXXXXXXXXXGXAXXXXXXXXXXXXXXXXXXX,0,483,117

14490,39,7,32,180,264,0,0,415,329,86,GAXOOOXXXXXXXXXXXXXXXXGOOOAOOOXXXXXXXXXXXXXXGXXXXXXXXXXXXXXXXXXXXXGAAXXXXXXXXXXXXXXXXXXXGXXXXXXXXXXXXXXXXXXXXXGAXXXXXXXXXXXXXXXXXXXXGAXXXXXXXXXXXXXXXXXXXXGOXXXXXXXXXXXXXXXXXXXXGXOOXXXXXXXXXXXXXXXXXXGXXOXXXXXXXXXXXXXXXXXXGOOOXXXXXXXXXXXXXXXXXXGOOOXXXXXXXXXXXXXXXXXXGXAXXXXXXXXXXXXXXXXXXX,0,483,117
14511,39,7,32,179,265,0,0,416,326,90,GAXOOOXXXXXXXXXXXXXXXXGOOOAOOOXXXXXXXXXXXXXXGXXXXXXXXXXXXXXXXXXXXXGAAXXXXXXXXXXXXXXXXXXXGXXXXXXXXXXXXXXXXXXXXXGAXXXXXXXXXXXXXXXXXXXXGAXXXXXXXXXXXXXXXXXXXXGOXXXXXXXXXXXXXXXXXXXXGXOOXXXXXXXXXXXXXXXXXXGXXOXXXXXXXXXXXXXXXXXXGOOOXXXXXXXXXXXXXXXXXXGOOOXXXXXXXXXXXXXXXXXXGXAXXXXXXXXXXXXXXXXXXX,0,483,117
14532,40,8,32,176,266,0,0,418,325,93,GAXOOOXXXXXXXXXXXXXXXXGOOOAOOOAXXXXXXXXXXXXXGXXXXXXXXXXXXXXXXXXXXXGAAXXXXXXXXXXXXXXXXXXXGXXXXXXXXXXXXXXXXXXXXXGAXXXXXXXXXXXXXXXXXXXXGAXXXXXXXXXXXXXXXXXXXXGOXXXXXXXXXXXXXXXXXXXXGXOOXXXXXXXXXXXXXXXXXXGXXOXXXXXXXXXXXXXXXXXXGOOOXXXXXXXXXXXXXXXXXXGOOOXXXXXXXXXXXXXXXXXXGXAXXXXXXXXXXXXXXXXXXX,0,481,119
14553,40,8,32,180,262,0,0,414,324,90,GAXOOOXXXXXXXXXXXXXXXXGOOOAOOOAXXXXXXXXXXXXXGXXXXXXXXXXXXXXXXXXXXXGAAXXXXXXXXXXXXXXXXXXXGXXXXXXXXXXXXXXXXXXXXXGAXXXXXXXXXXXXXXXXXXXXGAXXXXXXXXXXXXXXXXXXXXGOXXXXXXXXXXXXXXXXXXXXGXOOXXXXXXXXXXXXXXXXXXGXXOXXXXXXXXXXXXXXXXXXGOOOXXXXXXXXXXXXXXXXXXGOOOXXXXXXXXXXXXXXXXXXGXAXXXXXXXXXXXXXXXXXXX,0,481,119
14574,42,10,32,179,261,0,0,413,325,88,GAXOOOAXXXXXXXXXXXXXXXGOOOAOOOAXXXXXXXXXXXXXGXXXXXXXXXXXXXXXXXXXXXGAAXXXXXXXXXXXXXXXXXXXGXXXXXXXXXXXXXXXXXXXXXGAXXXXXXXXXXXXXXXXXXXXGAXXXXXXXXXXXXXXXXXXXXGOXXXXXXXXXXXXXXXXXXXXGXOOXXXXXXXXXXXXXXXXXXGXXOXXXXXXXXXXXXXXXXXXGOOOXXXXXXXXXXXXXXXXXXGOOOXXXXXXXXXXXXXXXXXXGXAAXXXXXXXXXXXXXXXXXX,0,481,119

14595,43,11,32,181,258,0,0,410,326,84,GAXOOOAXXXXXXXXXXXXXXXGOOOAOOOAXXXXXXXXXXXXXGXXXXXXXXXXXXXXXXXXXXXGAAXXXXXXXXXXXXXXXXXXXGXXXXXXXXXXXXXXXXXXXXXGAXXXXXXXXXXXXXXXXXXXXGAAXXXXXXXXXXXXXXXXXXXGOXXXXXXXXXXXXXXXXXXXXGXOOXXXXXXXXXXXXXXXXXXGXXOXXXXXXXXXXXXXXXXXXGOOOXXXXXXXXXXXXXXXXXXGOOOXXXXXXXXXXXXXXXXXXGXAAXXXXXXXXXXXXXXXXXX,0,481,119
14616,42,11,31,180,259,0,0,411,325,86,GAXOOXAXXXXXXXXXXXXXXXGOOOAOOOAXXXXXXXXXXXXXGXXXXXXXXXXXXXXXXXXXXXGAAXXXXXXXXXXXXXXXXXXXGXXXXXXXXXXXXXXXXXXXXXGAXXXXXXXXXXXXXXXXXXXXGAAXXXXXXXXXXXXXXXXXXXGOXXXXXXXXXXXXXXXXXXXXGXOOXXXXXXXXXXXXXXXXXXGXXOXXXXXXXXXXXXXXXXXXGOOOXXXXXXXXXXXXXXXXXXGOOOXXXXXXXXXXXXXXXXXXGXAAXXXXXXXXXXXXXXXXXX,0,480,120
14637,38,10,28,182,261,0,0,409,326,83,GAXOOXXXXXXXXXXXXXXXXXGOOOAXXXXXXXXXXXXXXXXXGAXXXXXXXXXXXXXXXXXXXXGAAXXXXXXXXXXXXXXXXXXXGXXXXXXXXXXXXXXXXXXXXXGAXXXXXXXXXXXXXXXXXXXXGAAXXXXXXXXXXXXXXXXXXXGOXXXXXXXXXXXXXXXXXXXXGXOOXXXXXXXXXXXXXXXXXXGXXOXXXXXXXXXXXXXXXXXXGOOOXXXXXXXXXXXXXXXXXXGOOOXXXXXXXXXXXXXXXXXXGXAAXXXXXXXXXXXXXXXXXX,0,480,120
14658,38,10,28,181,261,0,0,411,328,83,GAXOOXXXXXXXXXXXXXXXXXGOOXAXXXXXXXXXXXXXXXXXGAXXXXXXXXXXXXXXXXXXXXGOAXXXXXXXXXXXXXXXXXXXGXXXXXXXXXXXXXXXXXXXXXGAXXXXXXXXXXXXXXXXXXXXGAAXXXXXXXXXXXXXXXXXXXGOAXXXXXXXXXXXXXXXXXXXGXOOXXXXXXXXXXXXXXXXXXGXXOXXXXXXXXXXXXXXXXXXGOOOXXXXXXXXXXXXXXXXXXGOOOXXXXXXXXXXXXXXXXXXGXAAXXXXXXXXXXXXXXXXXX,0,479,121
14679,39,11,28,182,259,0,0,408,321,87,GAXOOXXXXXXXXXXXXXXXXXGOOXAXXXXXXXXXXXXXXXXXGAAXXXXXXXXXXXXXXXXXXXGOAXXXXXXXXXXXXXXXXXXXGXXXXXXXXXXXXXXXXXXXXXGAXXXXXXXXXXXXXXXXXXXXGAAXXXXXXXXXXXXXXXXXXXGOAXXXXXXXXXXXXXXXXXXXGXOOXXXXXXXXXXXXXXXXXXGXXOXXXXXXXXXXXXXXXXXXGOOOXXXXXXXXXXXXXXXXXXGOOOXXXXXXXXXXXXXXXXXXGXAAXXXXXXXXXXXXXXXXXX,0,479,121

14700,36,10,26,181,263,0,0,409,322,87,GAXXXXXXXXXXXXXXXXXXXXGOOXXXXXXXXXXXXXXXXXXXGAAXXXXXXXXXXXXXXXXXXXGOAXXXXXXXXXXXXXXXXXXXGXXXXXXXXXXXXXXXXXXXXXGAXXXXXXXXXXXXXXXXXXXXGAAXXXXXXXXXXXXXXXXXXXGOAXXXXXXXXXXXXXXXXXXXGXOOXXXXXXXXXXXXXXXXXXGXXOXXXXXXXXXXXXXXXXXXGOOOXXXXXXXXXXXXXXXXXXGOOOXXXXXXXXXXXXXXXXXXGXAAXXXXXXXXXXXXXXXXXX,0,479,121
14721,36,10,26,184,260,0,0,407,319,88,GAXXXXXXXXXXXXXXXXXXXXGOOXXXXXXXXXXXXXXXXXXXGAAXXXXXXXXXXXXXXXXXXXGOAXXXXXXXXXXXXXXXXXXXGXXXXXXXXXXXXXXXXXXXXXGAXXXXXXXXXXXXXXXXXXXXGAAXXXXXXXXXXXXXXXXXXXGOAXXXXXXXXXXXXXXXXXXXGXOOXXXXXXXXXXXXXXXXXXGXXOXXXXXXXXXXXXXXXXXXGOOOXXXXXXXXXXXXXXXXXXGOOOXXXXXXXXXXXXXXXXXXGXAAXXXXXXXXXXXXXXXXXX,0,479,121
14742,36,10,26,186,257,0,0,406,317,89,GAXXXXXXXXXXXXXXXXXXXXGOOXXXXXXXXXXXXXXXXXXXGAAXXXXXXXXXXXXXXXXXXXGOAXXXXXXXXXXXXXXXXXXXGXXXXXXXXXXXXXXXXXXXXXGAXXXXXXXXXXXXXXXXXXXXGAAXXXXXXXXXXXXXXXXXXXGOAXXXXXXXXXXXXXXXXXXXGXOXXXXXXXXXXXXXXXXXXXGXXOXXXXXXXXXXXXXXXXXXGOOOAXXXXXXXXXXXXXXXXXGOOOXXXXXXXXXXXXXXXXXXGXOAXXXXXXXXXXXXXXXXXX,0,478,122
14763,38,12,26,185,256,0,0,403,313,90,GAXXXXXXXXXXXXXXXXXXXXGOOAXXXXXXXXXXXXXXXXXXGAAXXXXXXXXXXXXXXXXXXXGOAXXXXXXXXXXXXXXXXXXXGXXXXXXXXXXXXXXXXXXXXXGAXXXXXXXXXXXXXXXXXXXXGAAXXXXXXXXXXXXXXXXXXXGOAXXXXXXXXXXXXXXXXXXXGXOXXXXXXXXXXXXXXXXXXXGXXOAXXXXXXXXXXXXXXXXXGOOOAXXXXXXXXXXXXXXXXXGOOOXXXXXXXXXXXXXXXXXXGXOAXXXXXXXXXXXXXXXXXX,0,478,122
14784,39,13,26,184,256,0,0,404,312,92,GAXXXXXXXXXXXXXXXXXXXXGOOAXXXXXXXXXXXXXXXXXXGAAXXXXXXXXXXXXXXXXXXXGOAXXXXXXXXXXXXXXXXXXXGXXXXXXXXXXXXXXXXXXXXXGAXXXXXXXXXXXXXXXXXXXXGAAXXXXXXXXXXXXXXXXXXXGOAAXXXXXXXXXXXXXXXXXXGXOXXXXXXXXXXXXXXXXXXXGXXOAXXXXXXXXXXXXXXXXXGOOOAXXXXXXXXXXXXXXXXXGOOOXXXXXXXXXXXXXXXXXXGXOAXXXXXXXXXXXXXXXXXX,0,478,122

14805,39,13,26,180,260,0,0,409,311,98,GAXXXXXXXXXXXXXXXXXXXXGOOAXXXXXXXXXXXXXXXXXXGAAXXXXXXXXXXXXXXXXXXXGOAXXXXXXXXXXXXXXXXXXXGXXXXXXXXXXXXXXXXXXXXXGAXXXXXXXXXXXXXXXXXXXXGAAXXXXXXXXXXXXXXXXXXXGOAAXXXXXXXXXXXXXXXXXXGXOXXXXXXXXXXXXXXXXXXXGXXOAXXXXXXXXXXXXXXXXXGOOOAXXXXXXXXXXXXXXXXXGOOOXXXXXXXXXXXXXXXXXXGXOAXXXXXXXXXXXXXXXXXX,0,478,122
14826,39,13,26,177,263,0,0,412,310,102,GAXXXXXXXXXXXXXXXXXXXXGOOAXXXXXXXXXXXXXXXXXXGAAXXXXXXXXXXXXXXXXXXXGOAXXXXXXXXXXXXXXXXXXXGXXXXXXXXXXXXXXXXXXXXXGAXXXXXXXXXXXXXXXXXXXXGAAXXXXXXXXXXXXXXXXXXXGOAAXXXXXXXXXXXXXXXXXXGXOXXXXXXXXXXXXXXXXXXXGXXOAXXXXXXXXXXXXXXXXXGOOOAXXXXXXXXXXXXXXXXXGOOOXXXXXXXXXXXXXXXXXXGXOAXXXXXXXXXXXXXXXXXX,0,478,122
14847,40,12,28,173,266,0,0,417,313,104,GAXXXXXXXXXXXXXXXXXXXXGOOAXXXXXXXXXXXXXXXXXXGAAXXXXXXXXXXXXXXXXXXXGOOXXXXXXXXXXXXXXXXXXXGXXXXXXXXXXXXXXXXXXXXXGAXXXXXXXXXXXXXXXXXXXXGAAXXXXXXXXXXXXXXXXXXXGOOAXXXXXXXXXXXXXXXXXXGXOAXXXXXXXXXXXXXXXXXXGXXOAXXXXXXXXXXXXXXXXXGOOOAXXXXXXXXXXXXXXXXXGOOOXXXXXXXXXXXXXXXXXXGXOAXXXXXXXXXXXXXXXXXX,0,478,122
14868,41,12,29,175,263,0,0,415,315,100,GOAXXXXXXXXXXXXXXXXXXXGOOAXXXXXXXXXXXXXXXXXXGAAXXXXXXXXXXXXXXXXXXXGOOXXXXXXXXXXXXXXXXXXXGXXXXXXXXXXXXXXXXXXXXXGAXXXXXXXXXXXXXXXXXXXXGAAXXXXXXXXXXXXXXXXXXXGOOAXXXXXXXXXXXXXXXXXXGXOAXXXXXXXXXXXXXXXXXXGXXOAXXXXXXXXXXXXXXXXXGOOOAXXXXXXXXXXXXXXXXXGOOOXXXXXXXXXXXXXXXXXXGXOAXXXXXXXXXXXXXXXXXX,0,478,122
14889,40,12,28,176,262,0,0,415,316,99,GOAXXXXXXXXXXXXXXXXXXXGOOAXXXXXXXXXXXXXXXXXXGAAXXXXXXXXXXXXXXXXXXXGOXXXXXXXXXXXXXXXXXXXXGXXXXXXXXXXXXXXXXXXXXXGAXXXXXXXXXXXXXXXXXXXXGAAXXXXXXXXXXXXXXXXXXXGOOAXXXXXXXXXXXXXXXXXXGXOAXXXXXXXXXXXXXXXXXXGXXOAXXXXXXXXXXXXXXXXXGOOOAXXXXXXXXXXXXXXXXXGOOOXXXXXXXXXXXXXXXXXXGXOAXXXXXXXXXXXXXXXXXX,0,477,123

14910,40,12,28,180,258,0,0,411,315,96,GOAXXXXXXXXXXXXXXXXXXXGOOAXXXXXXXXXXXXXXXXXXGAAXXXXXXXXXXXXXXXXXXXGOXXXXXXXXXXXXXXXXXXXXGXXXXXXXXXXXXXXXXXXXXXGAXXXXXXXXXXXXXXXXXXXXGAAXXXXXXXXXXXXXXXXXXXGOOAXXXXXXXXXXXXXXXXXXGXOAXXXXXXXXXXXXXXXXXXGXXOAXXXXXXXXXXXXXXXXXGOOOAXXXXXXXXXXXXXXXXXGOOOXXXXXXXXXXXXXXXXXXGXOAXXXXXXXXXXXXXXXXXX,0,477,123
14931,40,11,29,175,263,0,0,417,318,99,GOAXXXXXXXXXXXXXXXXXXXGOOAXXXXXXXXXXXXXXXXXXGAAXXXXXXXXXXXXXXXXXXXGOXXXXXXXXXXXXXXXXXXXXGXXXXXXXXXXXXXXXXXXXXXGOXXXXXXXXXXXXXXXXXXXXGAAXXXXXXXXXXXXXXXXXXXGOOAXXXXXXXXXXXXXXXXXXGXOAXXXXXXXXXXXXXXXXXXGXXOAXXXXXXXXXXXXXXXXXGOOOAXXXXXXXXXXXXXXXXXGOOOXXXXXXXXXXXXXXXXXXGXOAXXXXXXXXXXXXXXXXXX,0,477,123
14952,41,12,29,177,260,0,0,413,317,96,GOAXXXXXXXXXXXXXXXXXXXGOOAXXXXXXXXXXXXXXXXXXGAAXXXXXXXXXXXXXXXXXXXGOXXXXXXXXXXXXXXXXXXXXGXXXXXXXXXXXXXXXXXXXXXGOXXXXXXXXXXXXXXXXXXXXGAAXXXXXXXXXXXXXXXXXXXGOOAXXXXXXXXXXXXXXXXXXGXOAXXXXXXXXXXXXXXXXXXGXXOAXXXXXXXXXXXXXXXXXGOOOAXXXXXXXXXXXXXXXXXGOOOXXXXXXXXXXXXXXXXXXGXOAAXXXXXXXXXXXXXXXXX,0,477,123
14973,41,12,29,176,261,0,0,414,319,95,GOAXXXXXXXXXXXXXXXXXXXGOOAXXXXXXXXXXXXXXXXXXGAAXXXXXXXXXXXXXXXXXXXGOXXXXXXXXXXXXXXXXXXXXGXXXXXXXXXXXXXXXXXXXXXGOXXXXXXXXXXXXXXXXXXXXGAAXXXXXXXXXXXXXXXXXXXGOOAXXXXXXXXXXXXXXXXXXGXOAXXXXXXXXXXXXXXXXXXGXXOAXXXXXXXXXXXXXXXXXGOOOAXXXXXXXXXXXXXXXXXGOOOXXXXXXXXXXXXXXXXXXGXOAAXXXXXXXXXXXXXXXXX,0,477,123
14994,40,12,28,179,258,0,0,411,315,96,GOAXXXXXXXXXXXXXXXXXXXGOOAXXXXXXXXXXXXXXXXXXGAAXXXXXXXXXXXXXXXXXXXGOXXXXXXXXXXXXXXXXXXXXGXXXXXXXXXXXXXXXXXXXXXGXXXXXXXXXXXXXXXXXXXXXGAAXXXXXXXXXXXXXXXXXXXGOOAXXXXXXXXXXXXXXXXXXGXOAXXXXXXXXXXXXXXXXXXGXXOAXXXXXXXXXXXXXXXXXGOOOAXXXXXXXXXXXXXXXXXGOOOXXXXXXXXXXXXXXXXXXGXOAAXXXXXXXXXXXXXXXXX,0,476,124

15015,40,11,29,174,263,0,0,417,320,97,GOAXXXXXXXXXXXXXXXXXXXGOOAXXXXXXXXXXXXXXXXXXGAAXXXXXXXXXXXXXXXXXXXGOXXXXXXXXXXXXXXXXXXXXGXXXXXXXXXXXXXXXXXXXXXGXXXXXXXXXXXXXXXXXXXXXGAOXXXXXXXXXXXXXXXXXXXGOOAXXXXXXXXXXXXXXXXXXGXOAXXXXXXXXXXXXXXXXXXGXXOAXXXXXXXXXXXXXXXXXGOOOAXXXXXXXXXXXXXXXXXGOOOXXXXXXXXXXXXXXXXXXGXOAAXXXXXXXXXXXXXXXXX,0,476,124
15036,41,12,29,178,258,0,0,412,321,91,GOAXXXXXXXXXXXXXXXXXXXGOOAXXXXXXXXXXXXXXXXXXGAAXXXXXXXXXXXXXXXXXXXGOXXXXXXXXXXXXXXXXXXXXGXXXXXXXXXXXXXXXXXXXXXGXXXXXXXXXXXXXXXXXXXXXGAOXXXXXXXXXXXXXXXXXXXGOOAXXXXXXXXXXXXXXXXXXGXOAXXXXXXXXXXXXXXXXXXGXXOAAXXXXXXXXXXXXXXXXGOOOAXXXXXXXXXXXXXXXXXGOOOXXXXXXXXXXXXXXXXXXGXOAAXXXXXXXXXXXXXXXXX,0,476,124
15057,42,12,30,175,260,0,0,414,324,90,GOAXXXXXXXXXXXXXXXXXXXGOOAXXXXXXXXXXXXXXXXXXGAAXXXXXXXXXXXXXXXXXXXGOXXXXXXXXXXXXXXXXXXXXGAXXXXXXXXXXXXXXXXXXXXGXXXXXXXXXXXXXXXXXXXXXGAOXXXXXXXXXXXXXXXXXXXGOOAXXXXXXXXXXXXXXXXXXGXOAXXXXXXXXXXXXXXXXXXGXXOOAXXXXXXXXXXXXXXXXGOOOAXXXXXXXXXXXXXXXXXGOOOXXXXXXXXXXXXXXXXXXGXOAAXXXXXXXXXXXXXXXXX,0,476,124
15078,41,12,29,177,258,0,0,413,324,89,GOAXXXXXXXXXXXXXXXXXXXGOOAXXXXXXXXXXXXXXXXXXGAAXXXXXXXXXXXXXXXXXXXGOXXXXXXXXXXXXXXXXXXXXGAXXXXXXXXXXXXXXXXXXXXGXXXXXXXXXXXXXXXXXXXXXGAOXXXXXXXXXXXXXXXXXXXGXOAXXXXXXXXXXXXXXXXXXGXOAXXXXXXXXXXXXXXXXXXGXXOOAXXXXXXXXXXXXXXXXGOOOAXXXXXXXXXXXXXXXXXGOOOXXXXXXXXXXXXXXXXXXGXOAAXXXXXXXXXXXXXXXXX,0,475,125
15099,42,13,29,178,256,0,0,411,325,86,GOAXXXXXXXXXXXXXXXXXXXGOOAXXXXXXXXXXXXXXXXXXGAAXXXXXXXXXXXXXXXXXXXGOXXXXXXXXXXXXXXXXXXXXGAXXXXXXXXXXXXXXXXXXXXGXXXXXXXXXXXXXXXXXXXXXGAOXXXXXXXXXXXXXXXXXXXGXOAXXXXXXXXXXXXXXXXXXGXOAXXXXXXXXXXXXXXXXXXGXXOOAXXXXXXXXXXXXXXXXGOOOAAXXXXXXXXXXXXXXXXGOOOXXXXXXXXXXXXXXXXXXGXOAAXXXXXXXXXXXXXXXXX,0,475,125

15120,42,13,29,174,260,0,0,415,327,88,GOAXXXXXXXXXXXXXXXXXXXGOOAXXXXXXXXXXXXXXXXXXGAAXXXXXXXXXXXXXXXXXXXGOXXXXXXXXXXXXXXXXXXXXGAXXXXXXXXXXXXXXXXXXXXGXXXXXXXXXXXXXXXXXXXXXGAOXXXXXXXXXXXXXXXXXXXGXOAXXXXXXXXXXXXXXXXXXGXOAXXXXXXXXXXXXXXXXXXGXXOOAXXXXXXXXXXXXXXXXGOOOAAXXXXXXXXXXXXXXXXGOOOXXXXXXXXXXXXXXXXXXGXOAAXXXXXXXXXXXXXXXXX,0,475,125
15141,44,14,30,173,259,0,0,415,330,85,GOAXXXXXXXXXXXXXXXXXXXGOOAAXXXXXXXXXXXXXXXXXGAAXXXXXXXXXXXXXXXXXXXGOXXXXXXXXXXXXXXXXXXXXGAXXXXXXXXXXXXXXXXXXXXGXXXXXXXXXXXXXXXXXXXXXGAOXXXXXXXXXXXXXXXXXXXGXOAXXXXXXXXXXXXXXXXXXGXOAXXXXXXXXXXXXXXXXXXGXXOOAOXXXXXXXXXXXXXXXGOOOAAXXXXXXXXXXXXXXXXGOOOXXXXXXXXXXXXXXXXXXGXOAAXXXXXXXXXXXXXXXXX,0,475,125
15162,44,14,30,176,256,0,0,412,331,81,GOAXXXXXXXXXXXXXXXXXXXGOOAAXXXXXXXXXXXXXXXXXGAAXXXXXXXXXXXXXXXXXXXGOXXXXXXXXXXXXXXXXXXXXGAXXXXXXXXXXXXXXXXXXXXGXXXXXXXXXXXXXXXXXXXXXGAOXXXXXXXXXXXXXXXXXXXGXOAXXXXXXXXXXXXXXXXXXGXOAXXXXXXXXXXXXXXXXXXGXXOOAOXXXXXXXXXXXXXXXGOOOAAXXXXXXXXXXXXXXXXGOOOXXXXXXXXXXXXXXXXXXGXOAAXXXXXXXXXXXXXXXXX,0,475,125
15183,45,14,31,172,259,0,0,415,333,82,GOAXXXXXXXXXXXXXXXXXXXGOOAAXXXXXXXXXXXXXXXXXGAAXXXXXXXXXXXXXXXXXXXGOXXXXXXXXXXXXXXXXXXXXGAXXXXXXXXXXXXXXXXXXXXGXXXXXXXXXXXXXXXXXXXXXGAOXXXXXXXXXXXXXXXXXXXGXOAXXXXXXXXXXXXXXXXXXGXOAOXXXXXXXXXXXXXXXXXGXXOOAOXXXXXXXXXXXXXXXGOOOAAXXXXXXXXXXXXXXXXGOOOXXXXXXXXXXXXXXXXXXGXOAAXXXXXXXXXXXXXXXXX,0,475,125
15204,46,14,32,172,258,0,0,416,334,82,GOAXXXXXXXXXXXXXXXXXXXGOOAAXXXXXXXXXXXXXXXXXGAAXXXXXXXXXXXXXXXXXXXGOXXXXXXXXXXXXXXXXXXXXGAXXXXXXXXXXXXXXXXXXXXGXXXXXXXXXXXXXXXXXXXXXGAOXXXXXXXXXXXXXXXXXXXGXOAXXXXXXXXXXXXXXXXXXGXOOOXXXXXXXXXXXXXXXXXGXXOOAOXXXXXXXXXXXXXXXGOOOAAAXXXXXXXXXXXXXXXGOOOXXXXXXXXXXXXXXXXXXGXOAAXXXXXXXXXXXXXXXXX,0,475,125

15225,48,15,33,175,253,0,0,412,333,79,GOAXXXXXXXXXXXXXXXXXXXGOOAAXXXXXXXXXXXXXXXXXGOAAXXXXXXXXXXXXXXXXXXGOXXXXXXXXXXXXXXXXXXXXGAXXXXXXXXXXXXXXXXXXXXGXXXXXXXXXXXXXXXXXXXXXGAOXXXXXXXXXXXXXXXXXXXGXOAXXXXXXXXXXXXXXXXXXGXOOOXXXXXXXXXXXXXXXXXGXXOOAOAXXXXXXXXXXXXXXGOOOAAAXXXXXXXXXXXXXXXGOOOXXXXXXXXXXXXXXXXXXGXOAAXXXXXXXXXXXXXXXXX,0,475,125
15246,48,15,33,174,254,0,0,413,332,81,GOAXXXXXXXXXXXXXXXXXXXGOOAAXXXXXXXXXXXXXXXXXGOAAXXXXXXXXXXXXXXXXXXGOXXXXXXXXXXXXXXXXXXXXGAXXXXXXXXXXXXXXXXXXXXGXXXXXXXXXXXXXXXXXXXXXGAOXXXXXXXXXXXXXXXXXXXGXOAXXXXXXXXXXXXXXXXXXGXOOOXXXXXXXXXXXXXXXXXGXXOOAOAXXXXXXXXXXXXXXGOOOAAAXXXXXXXXXXXXXXXGOOOXXXXXXXXXXXXXXXXXXGXOAAXXXXXXXXXXXXXXXXX,0,475,125
15267,48,15,33,179,249,0,0,408,327,81,GOAXXXXXXXXXXXXXXXXXXXGOOAAXXXXXXXXXXXXXXXXXGOAAXXXXXXXXXXXXXXXXXXGOXXXXXXXXXXXXXXXXXXXXGAXXXXXXXXXXXXXXXXXXXXGXXXXXXXXXXXXXXXXXXXXXGAOXXXXXXXXXXXXXXXXXXXGXOAXXXXXXXXXXXXXXXXXXGXOOOXXXXXXXXXXXXXXXXXGXXOOAOAXXXXXXXXXXXXXXGOOOAAAXXXXXXXXXXXXXXXGOOOXXXXXXXXXXXXXXXXXXGXOAAXXXXXXXXXXXXXXXXX,0,475,125
15288,49,15,34,176,250,0,0,411,325,86,GOAXXXXXXXXXXXXXXXXXXXGOOOAXXXXXXXXXXXXXXXXXGAAOXXXXXXXXXXXXXXXXXXGOXXXXXXXXXXXXXXXXXXXXGAXXXXXXXXXXXXXXXXXXXXGXXXXXXXXXXXXXXXXXXXXXGAOXXXXXXXXXXXXXXXXXXXGXOAXXXXXXXXXXXXXXXXXXGXOOOXXXXXXXXXXXXXXXXXGAXOOAOAXXXXXXXXXXXXXXGOOOAAAXXXXXXXXXXXXXXXGOOOXXXXXXXXXXXXXXXXXXGXOAAXXXXXXXXXXXXXXXXX,0,474,126
15309,49,16,33,174,251,0,0,412,329,83,GXAXXXXXXXXXXXXXXXXXXXGOOOAXXXXXXXXXXXXXXXXXGAAOXXXXXXXXXXXXXXXXXXGOXXXXXXXXXXXXXXXXXXXXGAXXXXXXXXXXXXXXXXXXXXGXXXXXXXXXXXXXXXXXXXXXGAOXXXXXXXXXXXXXXXXXXXGXOAAXXXXXXXXXXXXXXXXXGXOOOXXXXXXXXXXXXXXXXXGAXOOAOAXXXXXXXXXXXXXXGOOOAAAXXXXXXXXXXXXXXXGOOOXXXXXXXXXXXXXXXXXXGXOAAXXXXXXXXXXXXXXXXX,0,473,127

15330,50,17,33,176,248,0,0,409,328,81,GXAXXXXXXXXXXXXXXXXXXXGOOOAXXXXXXXXXXXXXXXXXGAAOXXXXXXXXXXXXXXXXXXGOXXXXXXXXXXXXXXXXXXXXGAXXXXXXXXXXXXXXXXXXXXGXXXXXXXXXXXXXXXXXXXXXGAOXXXXXXXXXXXXXXXXXXXGXOAAXXXXXXXXXXXXXXXXXGXOOOXXXXXXXXXXXXXXXXXGAXOOAOAXXXXXXXXXXXXXXGOOOAAAXXXXXXXXXXXXXXXGOOOXXXXXXXXXXXXXXXXXXGAOAAXXXXXXXXXXXXXXXXX,0,473,127
15351,50,17,33,178,245,0,0,407,326,81,GXAXXXXXXXXXXXXXXXXXXXGOOOAXXXXXXXXXXXXXXXXXGAAOXXXXXXXXXXXXXXXXXXGOXXXXXXXXXXXXXXXXXXXXGAXXXXXXXXXXXXXXXXXXXXGXXXXXXXXXXXXXXXXXXXXXGAOXXXXXXXXXXXXXXXXXXXGXOAOXXXXXXXXXXXXXXXXXGXOOOXXXXXXXXXXXXXXXXXGAXOOAXAAXXXXXXXXXXXXXGOOOAAAXXXXXXXXXXXXXXXGOOOXXXXXXXXXXXXXXXXXXGAOAAXXXXXXXXXXXXXXXXX,0,472,128
15372,48,15,33,182,243,0,0,405,320,85,GXAXXXXXXXXXXXXXXXXXXXGOOOAXXXXXXXXXXXXXXXXXGAAOXXXXXXXXXXXXXXXXXXGOXXXXXXXXXXXXXXXXXXXXGAXXXXXXXXXXXXXXXXXXXXGXXXXXXXXXXXXXXXXXXXXXGAOXXXXXXXXXXXXXXXXXXXGXOAOXXXXXXXXXXXXXXXXXGXOOOXXXXXXXXXXXXXXXXXGAXOOAXXXXXXXXXXXXXXXXGOOOAAAXXXXXXXXXXXXXXXGOOOXXXXXXXXXXXXXXXXXXGAOAAXXXXXXXXXXXXXXXXX,0,472,128
15393,47,15,32,185,240,0,0,402,318,84,GXAXXXXXXXXXXXXXXXXXXXGOOOAXXXXXXXXXXXXXXXXXGAAOXXXXXXXXXXXXXXXXXXGOXXXXXXXXXXXXXXXXXXXXGAXXXXXXXXXXXXXXXXXXXXGXXXXXXXXXXXXXXXXXXXXXGAOXXXXXXXXXXXXXXXXXXXGXXAOXXXXXXXXXXXXXXXXXGXOOOXXXXXXXXXXXXXXXXXGAXOOAXXXXXXXXXXXXXXXXGOOOAAAXXXXXXXXXXXXXXXGOOOXXXXXXXXXXXXXXXXXXGAOAAXXXXXXXXXXXXXXXXX,0,471,129
15414,47,15,32,185,240,0,0,402,316,86,GXAXXXXXXXXXXXXXXXXXXXGOOOAXXXXXXXXXXXXXXXXXGAAOXXXXXXXXXXXXXXXXXXGOXXXXXXXXXXXXXXXXXXXXGAXXXXXXXXXXXXXXXXXXXXGXXXXXXXXXXXXXXXXXXXXXGAOXXXXXXXXXXXXXXXXXXXGXXAOXXXXXXXXXXXXXXXXXGXOOOXXXXXXXXXXXXXXXXXGAXOOAXXXXXXXXXXXXXXXXGOOOAAAXXXXXXXXXXXXXXXGOOOXXXXXXXXXXXXXXXXXXGAOAAXXXXXXXXXXXXXXXXX,0,471,129

15435,47,15,32,185,240,0,0,401,320,81,GXAXXXXXXXXXXXXXXXXXXXGOOOAXXXXXXXXXXXXXXXXXGAAOXXXXXXXXXXXXXXXXXXGOXXXXXXXXXXXXXXXXXXXXGAXXXXXXXXXXXXXXXXXXXXGXXXXXXXXXXXXXXXXXXXXXGAOXXXXXXXXXXXXXXXXXXXGXXAOXXXXXXXXXXXXXXXXXGXOOOXXXXXXXXXXXXXXXXXGAXOOAXXXXXXXXXXXXXXXXGOOOAAAXXXXXXXXXXXXXXXGOOOXXXXXXXXXXXXXXXXXXGAOAAXXXXXXXXXXXXXXXXX,0,471,129
15456,47,15,32,183,242,0,0,405,321,84,GXAXXXXXXXXXXXXXXXXXXXGOOOAXXXXXXXXXXXXXXXXXGAAOXXXXXXXXXXXXXXXXXXGOXXXXXXXXXXXXXXXXXXXXGAXXXXXXXXXXXXXXXXXXXXGXXXXXXXXXXXXXXXXXXXXXGAOXXXXXXXXXXXXXXXXXXXGXXAOXXXXXXXXXXXXXXXXXGXOOOXXXXXXXXXXXXXXXXXGAXOOAXXXXXXXXXXXXXXXXGOOOAAAXXXXXXXXXXXXXXXGOOOXXXXXXXXXXXXXXXXXXGAOAAXXXXXXXXXXXXXXXXX,0,471,129
15477,46,14,32,184,241,0,0,405,318,87,GXAXXXXXXXXXXXXXXXXXXXGOOOAXXXXXXXXXXXXXXXXXGAAOXXXXXXXXXXXXXXXXXXGOXXXXXXXXXXXXXXXXXXXXGAXXXXXXXXXXXXXXXXXXXXGXXXXXXXXXXXXXXXXXXXXXGAXXXXXXXXXXXXXXXXXXXXGXXAOXXXXXXXXXXXXXXXXXGXOOOXXXXXXXXXXXXXXXXXGAXOOOXXXXXXXXXXXXXXXXGOOOAAAXXXXXXXXXXXXXXXGOOOXXXXXXXXXXXXXXXXXXGAOAAXXXXXXXXXXXXXXXXX,0,470,130
15498,44,14,30,181,244,0,0,406,315,91,GXAXXXXXXXXXXXXXXXXXXXGOOOAXXXXXXXXXXXXXXXXXGAAXXXXXXXXXXXXXXXXXXXGOXXXXXXXXXXXXXXXXXXXXGAXXXXXXXXXXXXXXXXXXXXGXXXXXXXXXXXXXXXXXXXXXGAXXXXXXXXXXXXXXXXXXXXGXXAOXXXXXXXXXXXXXXXXXGXOOOXXXXXXXXXXXXXXXXXGAXOOOXXXXXXXXXXXXXXXXGOOOAAAXXXXXXXXXXXXXXXGXOOXXXXXXXXXXXXXXXXXXGAOAAXXXXXXXXXXXXXXXXX,0,468,132
15519,44,14,30,184,241,0,0,403,316,87,GXAXXXXXXXXXXXXXXXXXXXGOOOAXXXXXXXXXXXXXXXXXGAAXXXXXXXXXXXXXXXXXXXGOXXXXXXXXXXXXXXXXXXXXGAXXXXXXXXXXXXXXXXXXXXGXXXXXXXXXXXXXXXXXXXXXGAXXXXXXXXXXXXXXXXXXXXGXXAOXXXXXXXXXXXXXXXXXGXOOOXXXXXXXXXXXXXXXXXGAXOOOXXXXXXXXXXXXXXXXGOOOAAAXXXXXXXXXXXXXXXGXOOXXXXXXXXXXXXXXXXXXGAOAAXXXXXXXXXXXXXXXXX,0,468,132

15540,44,14,30,179,246,0,0,408,315,93,GXAXXXXXXXXXXXXXXXXXXXGOOOAXXXXXXXXXXXXXXXXXGAAXXXXXXXXXXXXXXXXXXXGOXXXXXXXXXXXXXXXXXXXXGAXXXXXXXXXXXXXXXXXXXXGXXXXXXXXXXXXXXXXXXXXXGAXXXXXXXXXXXXXXXXXXXXGXXAOXXXXXXXXXXXXXXXXXGXOOOXXXXXXXXXXXXXXXXXGAXOOOXXXXXXXXXXXXXXXXGOOOAAAXXXXXXXXXXXXXXXGXOOXXXXXXXXXXXXXXXXXXGAOAAXXXXXXXXXXXXXXXXX,0,468,132
15561,44,14,30,181,244,0,0,406,314,92,GXAXXXXXXXXXXXXXXXXXXXGOOOAXXXXXXXXXXXXXXXXXGAAXXXXXXXXXXXXXXXXXXXGOXXXXXXXXXXXXXXXXXXXXGAXXXXXXXXXXXXXXXXXXXXGXXXXXXXXXXXXXXXXXXXXXGAXXXXXXXXXXXXXXXXXXXXGXXAOXXXXXXXXXXXXXXXXXGXOOOXXXXXXXXXXXXXXXXXGAXOOOXXXXXXXXXXXXXXXXGOOOAAAXXXXXXXXXXXXXXXGXOOXXXXXXXXXXXXXXXXXXGAOAAXXXXXXXXXXXXXXXXX,0,468,132
15582,43,14,29,180,245,0,0,407,314,93,GXAXXXXXXXXXXXXXXXXXXXGOOOAXXXXXXXXXXXXXXXXXGAAXXXXXXXXXXXXXXXXXXXGOXXXXXXXXXXXXXXXXXXXXGAXXXXXXXXXXXXXXXXXXXXGXXXXXXXXXXXXXXXXXXXXXGAXXXXXXXXXXXXXXXXXXXXGXXAOXXXXXXXXXXXXXXXXXGXOOOXXXXXXXXXXXXXXXXXGAXOOOXXXXXXXXXXXXXXXXGOOOAAAXXXXXXXXXXXXXXXGXXOXXXXXXXXXXXXXXXXXXGAOAAXXXXXXXXXXXXXXXXX,0,467,133
15603,44,14,30,180,244,0,0,407,314,93,GXAXXXXXXXXXXXXXXXXXXXGOOOAXXXXXXXXXXXXXXXXXGAAXXXXXXXXXXXXXXXXXXXGOXXXXXXXXXXXXXXXXXXXXGAXXXXXXXXXXXXXXXXXXXXGXXXXXXXXXXXXXXXXXXXXXGAXXXXXXXXXXXXXXXXXXXXGXXAOXXXXXXXXXXXXXXXXXGAOOOXXXXXXXXXXXXXXXXXGAXOOOXXXXXXXXXXXXXXXXGOOOAAAXXXXXXXXXXXXXXXGXXOXXXXXXXXXXXXXXXXXXGAOOAXXXXXXXXXXXXXXXXX,0,467,133
15624,44,14,30,181,243,0,0,406,322,84,GXAXXXXXXXXXXXXXXXXXXXGOOOAXXXXXXXXXXXXXXXXXGAAXXXXXXXXXXXXXXXXXXXGOXXXXXXXXXXXXXXXXXXXXGAXXXXXXXXXXXXXXXXXXXXGXXXXXXXXXXXXXXXXXXXXXGAXXXXXXXXXXXXXXXXXXXXGXXAOXXXXXXXXXXXXXXXXXGAOOOXXXXXXXXXXXXXXXXXGAXOOOXXXXXXXXXXXXXXXXGOOOAAAXXXXXXXXXXXXXXXGXXOXXXXXXXXXXXXXXXXXXGAOOAXXXXXXXXXXXXXXXXX,0,467,133

15645,44,14,30,179,245,0,0,408,328,80,GXAXXXXXXXXXXXXXXXXXXXGOOOAXXXXXXXXXXXXXXXXXGAAXXXXXXXXXXXXXXXXXXXGOXXXXXXXXXXXXXXXXXXXXGAXXXXXXXXXXXXXXXXXXXXGXXXXXXXXXXXXXXXXXXXXXGAXXXXXXXXXXXXXXXXXXXXGXXAOXXXXXXXXXXXXXXXXXGAOOOXXXXXXXXXXXXXXXXXGAXOOOXXXXXXXXXXXXXXXXGOOOAAAXXXXXXXXXXXXXXXGXXOXXXXXXXXXXXXXXXXXXGAOOAXXXXXXXXXXXXXXXXX,0,467,133
15666,43,12,31,178,246,0,0,411,328,83,GXAXXXXXXXXXXXXXXXXXXXGOOOAXXXXXXXXXXXXXXXXXGAAXXXXXXXXXXXXXXXXXXXGOXXXXXXXXXXXXXXXXXXXXGOXXXXXXXXXXXXXXXXXXXXGXXXXXXXXXXXXXXXXXXXXXGAXXXXXXXXXXXXXXXXXXXXGXXAOXXXXXXXXXXXXXXXXXGAOOOXXXXXXXXXXXXXXXXXGAXOOOXXXXXXXXXXXXXXXXGOOOAAAXXXXXXXXXXXXXXXGXXOXXXXXXXXXXXXXXXXXXGAOOXXXXXXXXXXXXXXXXXX,0,466,134
15687,43,11,32,176,248,0,0,414,331,83,GXAXXXXXXXXXXXXXXXXXXXGOOOAXXXXXXXXXXXXXXXXXGAAXXXXXXXXXXXXXXXXXXXGOXXXXXXXXXXXXXXXXXXXXGOXXXXXXXXXXXXXXXXXXXXGXXXXXXXXXXXXXXXXXXXXXGAXXXXXXXXXXXXXXXXXXXXGXXAOXXXXXXXXXXXXXXXXXGAOOOXXXXXXXXXXXXXXXXXGAXOOOXXXXXXXXXXXXXXXXGOOOAOAXXXXXXXXXXXXXXXGXXOXXXXXXXXXXXXXXXXXXGAOOXXXXXXXXXXXXXXXXXX,0,466,134
15708,44,11,33,183,240,0,0,407,327,80,GXAXXXXXXXXXXXXXXXXXXXGOOOOXXXXXXXXXXXXXXXXXGAAXXXXXXXXXXXXXXXXXXXGOXXXXXXXXXXXXXXXXXXXXGOXXXXXXXXXXXXXXXXXXXXGXXXXXXXXXXXXXXXXXXXXXGAXXXXXXXXXXXXXXXXXXXXGXXAOXXXXXXXXXXXXXXXXXGAOOOXXXXXXXXXXXXXXXXXGAXOOOXXXXXXXXXXXXXXXXGOOOAOAAXXXXXXXXXXXXXXGXXOXXXXXXXXXXXXXXXXXXGAOOXXXXXXXXXXXXXXXXXX,0,466,134
15729,41,10,31,190,234,0,0,400,320,80,GXXXXXXXXXXXXXXXXXXXXXGOXOXXXXXXXXXXXXXXXXXXGAXXXXXXXXXXXXXXXXXXXXGOXXXXXXXXXXXXXXXXXXXXGOXXXXXXXXXXXXXXXXXXXXGXXXXXXXXXXXXXXXXXXXXXGAXXXXXXXXXXXXXXXXXXXXGXXAOXXXXXXXXXXXXXXXXXGAOOOXXXXXXXXXXXXXXXXXGAXOOOXXXXXXXXXXXXXXXXGOOOAOAAAXXXXXXXXXXXXXGXXOXXXXXXXXXXXXXXXXXXGAOOXXXXXXXXXXXXXXXXXX,0,464,136

15750,41,9,32,191,233,0,0,401,323,78,GXXXXXXXXXXXXXXXXXXXXXGOXOXXXXXXXXXXXXXXXXXXGAXXXXXXXXXXXXXXXXXXXXGOXXXXXXXXXXXXXXXXXXXXGOXXXXXXXXXXXXXXXXXXXXGXXXXXXXXXXXXXXXXXXXXXGAXXXXXXXXXXXXXXXXXXXXGXXAOXXXXXXXXXXXXXXXXXGAOOOXXXXXXXXXXXXXXXXXGAXOOOXXXXXXXXXXXXXXXXGOOOAOAAAXXXXXXXXXXXXXGXXOXXXXXXXXXXXXXXXXXXGOOOXXXXXXXXXXXXXXXXXX,0,464,136
15771,41,10,31,192,232,0,0,399,321,78,GXXXXXXXXXXXXXXXXXXXXXGOXXXXXXXXXXXXXXXXXXXXGAXXXXXXXXXXXXXXXXXXXXGOXXXXXXXXXXXXXXXXXXXXGOXXXXXXXXXXXXXXXXXXXXGXXXXXXXXXXXXXXXXXXXXXGAXXXXXXXXXXXXXXXXXXXXGXXAOXXXXXXXXXXXXXXXXXGAOOOXXXXXXXXXXXXXXXXXGAXOOOXXXXXXXXXXXXXXXXGOOOAOAAAAXXXXXXXXXXXXGXXOXXXXXXXXXXXXXXXXXXGOOOXXXXXXXXXXXXXXXXXX,0,464,136
15792,43,12,31,187,235,0,0,402,316,86,GXXXXXXXXXXXXXXXXXXXXXGOAXXXXXXXXXXXXXXXXXXXGAXXXXXXXXXXXXXXXXXXXXGOXXXXXXXXXXXXXXXXXXXXGOXXXXXXXXXXXXXXXXXXXXGXXXXXXXXXXXXXXXXXXXXXGAXXXXXXXXXXXXXXXXXXXXGXXAOXXXXXXXXXXXXXXXXXGAOOOXXXXXXXXXXXXXXXXXGAXOOOXXXXXXXXXXXXXXXXGOOOAOAAAAXXXXXXXXXXXXGXXOXXXXXXXXXXXXXXXXXXGOOOAXXXXXXXXXXXXXXXXX,0,464,136
15813,43,12,31,188,234,0,0,401,318,83,GXXXXXXXXXXXXXXXXXXXXXGOAXXXXXXXXXXXXXXXXXXXGAXXXXXXXXXXXXXXXXXXXXGOXXXXXXXXXXXXXXXXXXXXGOXXXXXXXXXXXXXXXXXXXXGXXXXXXXXXXXXXXXXXXXXXGAXXXXXXXXXXXXXXXXXXXXGXXAOXXXXXXXXXXXXXXXXXGAOOOXXXXXXXXXXXXXXXXXGAXOOOXXXXXXXXXXXXXXXXGOOOAOAAAAXXXXXXXXXXXXGXXOXXXXXXXXXXXXXXXXXXGOOOAXXXXXXXXXXXXXXXXX,0,464,136
15834,43,12,31,186,236,0,0,403,318,85,GXXXXXXXXXXXXXXXXXXXXXGOAXXXXXXXXXXXXXXXXXXXGAXXXXXXXXXXXXXXXXXXXXGOXXXXXXXXXXXXXXXXXXXXGOXXXXXXXXXXXXXXXXXXXXGXXXXXXXXXXXXXXXXXXXXXGAXXXXXXXXXXXXXXXXXXXXGXXAOXXXXXXXXXXXXXXXXXGAOOOXXXXXXXXXXXXXXXXXGAXOOOXXXXXXXXXXXXXXXXGOOOAOAAAAXXXXXXXXXXXXGXXOXXXXXXXXXXXXXXXXXXGOOOAXXXXXXXXXXXXXXXXX,0,464,136

15855,43,12,31,187,235,0,0,402,318,84,GXXXXXXXXXXXXXXXXXXXXXGOAXXXXXXXXXXXXXXXXXXXGAXXXXXXXXXXXXXXXXXXXXGOXXXXXXXXXXXXXXXXXXXXGOXXXXXXXXXXXXXXXXXXXXGXXXXXXXXXXXXXXXXXXXXXGAXXXXXXXXXXXXXXXXXXXXGXXAOXXXXXXXXXXXXXXXXXGAOOOXXXXXXXXXXXXXXXXXGAXOOOXXXXXXXXXXXXXXXXGOOOAOAAAAXXXXXXXXXXXXGXXOXXXXXXXXXXXXXXXXXXGOOOAXXXXXXXXXXXXXXXXX,0,464,136
15876,43,12,31,191,231,0,0,398,313,85,GXXXXXXXXXXXXXXXXXXXXXGOAXXXXXXXXXXXXXXXXXXXGAXXXXXXXXXXXXXXXXXXXXGOXXXXXXXXXXXXXXXXXXXXGOXXXXXXXXXXXXXXXXXXXXGXXXXXXXXXXXXXXXXXXXXXGAXXXXXXXXXXXXXXXXXXXXGXXAOXXXXXXXXXXXXXXXXXGAOOOXXXXXXXXXXXXXXXXXGAXOOOXXXXXXXXXXXXXXXXGOOOAOAAAAXXXXXXXXXXXXGXXOXXXXXXXXXXXXXXXXXXGOOOAXXXXXXXXXXXXXXXXX,0,464,136
15897,43,12,31,188,234,0,0,401,312,89,GXXXXXXXXXXXXXXXXXXXXXGOAXXXXXXXXXXXXXXXXXXXGAXXXXXXXXXXXXXXXXXXXXGOXXXXXXXXXXXXXXXXXXXXGOXXXXXXXXXXXXXXXXXXXXGXXXXXXXXXXXXXXXXXXXXXGAXXXXXXXXXXXXXXXXXXXXGXXAOXXXXXXXXXXXXXXXXXGAOOOXXXXXXXXXXXXXXXXXGAXOOOXXXXXXXXXXXXXXXXGOOOAOAAAAXXXXXXXXXXXXGXXOXXXXXXXXXXXXXXXXXXGOOOAXXXXXXXXXXXXXXXXX,0,464,136
15918,43,12,31,185,237,0,0,404,314,90,GXXXXXXXXXXXXXXXXXXXXXGOAXXXXXXXXXXXXXXXXXXXGAXXXXXXXXXXXXXXXXXXXXGOXXXXXXXXXXXXXXXXXXXXGOXXXXXXXXXXXXXXXXXXXXGXXXXXXXXXXXXXXXXXXXXXGAXXXXXXXXXXXXXXXXXXXXGXXAOXXXXXXXXXXXXXXXXXGAOOOXXXXXXXXXXXXXXXXXGAXOOOXXXXXXXXXXXXXXXXGOOOAOAAAAXXXXXXXXXXXXGXXOXXXXXXXXXXXXXXXXXXGOOOAXXXXXXXXXXXXXXXXX,0,464,136
15939,43,9,34,182,240,0,0,409,314,95,GXXXXXXXXXXXXXXXXXXXXXGOAXXXXXXXXXXXXXXXXXXXGAXXXXXXXXXXXXXXXXXXXXGOXXXXXXXXXXXXXXXXXXXXGOXXXXXXXXXXXXXXXXXXXXGXXXXXXXXXXXXXXXXXXXXXGAXXXXXXXXXXXXXXXXXXXXGXXAOXXXXXXXXXXXXXXXXXGAOOOXXXXXXXXXXXXXXXXXGAXOOOXXXXXXXXXXXXXXXXGOOOOOOOAAXXXXXXXXXXXXGXXOXXXXXXXXXXXXXXXXXXGOOOAXXXXXXXXXXXXXXXXX,0,464,136

15960,43,8,35,185,237,0,0,408,316,92,GXXXXXXXXXXXXXXXXXXXXXGOAXXXXXXXXXXXXXXXXXXXGAXXXXXXXXXXXXXXXXXXXXGOXXXXXXXXXXXXXXXXXXXXGOXXXXXXXXXXXXXXXXXXXXGXXXXXXXXXXXXXXXXXXXXXGAXXXXXXXXXXXXXXXXXXXXGXXAOXXXXXXXXXXXXXXXXXGAOOOXXXXXXXXXXXXXXXXXGAXOOOXXXXXXXXXXXXXXXXGOOOOOOOOAXXXXXXXXXXXXGXXOXXXXXXXXXXXXXXXXXXGOOOAXXXXXXXXXXXXXXXXX,0,464,136
15981,42,8,34,192,230,0,0,402,312,90,GXXXXXXXXXXXXXXXXXXXXXGOAXXXXXXXXXXXXXXXXXXXGAXXXXXXXXXXXXXXXXXXXXGOXXXXXXXXXXXXXXXXXXXXGOXXXXXXXXXXXXXXXXXXXXGXXXXXXXXXXXXXXXXXXXXXGAXXXXXXXXXXXXXXXXXXXXGXXAOXXXXXXXXXXXXXXXXXGAOOOXXXXXXXXXXXXXXXXXGAXOOOXXXXXXXXXXXXXXXXGOOOOOOOOAXXXXXXXXXXXXGXXXXXXXXXXXXXXXXXXXXXGOOOAXXXXXXXXXXXXXXXXX,0,463,137
16002,39,7,32,185,240,0,0,410,315,95,GXXXXXXXXXXXXXXXXXXXXXGOAXXXXXXXXXXXXXXXXXXXGAXXXXXXXXXXXXXXXXXXXXGOXXXXXXXXXXXXXXXXXXXXGOXXXXXXXXXXXXXXXXXXXXGXXXXXXXXXXXXXXXXXXXXXGAXXXXXXXXXXXXXXXXXXXXGXXAOXXXXXXXXXXXXXXXXXGAOOOXXXXXXXXXXXXXXXXXGAXOOOXXXXXXXXXXXXXXXXGOOOOOOOOAXXXXXXXXXXXXGXXXXXXXXXXXXXXXXXXXXXGOXXXXXXXXXXXXXXXXXXXX,0,463,137
16023,40,8,32,192,232,0,0,402,308,94,GXXXXXXXXXXXXXXXXXXXXXGOAXXXXXXXXXXXXXXXXXXXGAXXXXXXXXXXXXXXXXXXXXGOXXXXXXXXXXXXXXXXXXXXGOXXXXXXXXXXXXXXXXXXXXGXXXXXXXXXXXXXXXXXXXXXGAXXXXXXXXXXXXXXXXXXXXGXXAOXXXXXXXXXXXXXXXXXGAOOOXXXXXXXXXXXXXXXXXGAXOOOAXXXXXXXXXXXXXXXGOOOOOOOOAXXXXXXXXXXXXGXXXXXXXXXXXXXXXXXXXXXGOXXXXXXXXXXXXXXXXXXXX,0,463,137
16044,41,9,32,191,232,0,0,402,307,95,GXXXXXXXXXXXXXXXXXXXXXGOAXXXXXXXXXXXXXXXXXXXGAXXXXXXXXXXXXXXXXXXXXGOXXXXXXXXXXXXXXXXXXXXGOXXXXXXXXXXXXXXXXXXXXGAXXXXXXXXXXXXXXXXXXXXGAXXXXXXXXXXXXXXXXXXXXGXXAOXXXXXXXXXXXXXXXXXGAOOOXXXXXXXXXXXXXXXXXGAXOOOAXXXXXXXXXXXXXXXGOOOOOOOOAXXXXXXXXXXXXGXXXXXXXXXXXXXXXXXXXXXGOXXXXXXXXXXXXXXXXXXXX,0,463,137

16065,41,9,32,190,233,0,0,402,307,95,GXXXXXXXXXXXXXXXXXXXXXGOAXXXXXXXXXXXXXXXXXXXGAXXXXXXXXXXXXXXXXXXXXGOXXXXXXXXXXXXXXXXXXXXGOXXXXXXXXXXXXXXXXXXXXGAXXXXXXXXXXXXXXXXXXXXGAXXXXXXXXXXXXXXXXXXXXGXXAOXXXXXXXXXXXXXXXXXGAOOOXXXXXXXXXXXXXXXXXGAXOOOAXXXXXXXXXXXXXXXGOOOOOOOOAXXXXXXXXXXXXGXXXXXXXXXXXXXXXXXXXXXGOXXXXXXXXXXXXXXXXXXXX,0,463,137
16086,41,8,33,189,234,0,0,404,307,97,GXXXXXXXXXXXXXXXXXXXXXGOAXXXXXXXXXXXXXXXXXXXGAXXXXXXXXXXXXXXXXXXXXGOXXXXXXXXXXXXXXXXXXXXGOXXXXXXXXXXXXXXXXXXXXGAXXXXXXXXXXXXXXXXXXXXGOXXXXXXXXXXXXXXXXXXXXGXXAOXXXXXXXXXXXXXXXXXGAOOOXXXXXXXXXXXXXXXXXGAXOOOAXXXXXXXXXXXXXXXGOOOOOOOOAXXXXXXXXXXXXGXXXXXXXXXXXXXXXXXXXXXGOXXXXXXXXXXXXXXXXXXXX,0,463,137
16107,41,8,33,189,234,0,0,404,306,98,GXXXXXXXXXXXXXXXXXXXXXGOAXXXXXXXXXXXXXXXXXXXGAXXXXXXXXXXXXXXXXXXXXGOXXXXXXXXXXXXXXXXXXXXGOXXXXXXXXXXXXXXXXXXXXGAXXXXXXXXXXXXXXXXXXXXGOXXXXXXXXXXXXXXXXXXXXGXXAOXXXXXXXXXXXXXXXXXGAOOOXXXXXXXXXXXXXXXXXGAXOOOAXXXXXXXXXXXXXXXGOOOOOOOOAXXXXXXXXXXXXGXXXXXXXXXXXXXXXXXXXXXGOXXXXXXXXXXXXXXXXXXXX,0,463,137
16128,41,7,34,193,230,0,0,401,304,97,GXXXXXXXXXXXXXXXXXXXXXGOAXXXXXXXXXXXXXXXXXXXGAXXXXXXXXXXXXXXXXXXXXGOXXXXXXXXXXXXXXXXXXXXGOXXXXXXXXXXXXXXXXXXXXGOXXXXXXXXXXXXXXXXXXXXGOXXXXXXXXXXXXXXXXXXXXGXXAOXXXXXXXXXXXXXXXXXGAOOOXXXXXXXXXXXXXXXXXGAXOOOAXXXXXXXXXXXXXXXGOOOOOOOOAXXXXXXXXXXXXGXXXXXXXXXXXXXXXXXXXXXGOXXXXXXXXXXXXXXXXXXXX,0,463,137
16149,42,8,34,193,229,0,0,400,309,91,GAXXXXXXXXXXXXXXXXXXXXGOAXXXXXXXXXXXXXXXXXXXGAXXXXXXXXXXXXXXXXXXXXGOXXXXXXXXXXXXXXXXXXXXGOXXXXXXXXXXXXXXXXXXXXGOXXXXXXXXXXXXXXXXXXXXGOXXXXXXXXXXXXXXXXXXXXGXXAOXXXXXXXXXXXXXXXXXGAOOOXXXXXXXXXXXXXXXXXGAXOOOAXXXXXXXXXXXXXXXGOOOOOOOOAXXXXXXXXXXXXGXXXXXXXXXXXXXXXXXXXXXGOXXXXXXXXXXXXXXXXXXXX,0,463,137

16170,42,8,34,186,236,0,0,407,314,93,GAXXXXXXXXXXXXXXXXXXXXGOAXXXXXXXXXXXXXXXXXXXGAXXXXXXXXXXXXXXXXXXXXGOXXXXXXXXXXXXXXXXXXXXGOXXXXXXXXXXXXXXXXXXXXGOXXXXXXXXXXXXXXXXXXXXGOXXXXXXXXXXXXXXXXXXXXGXXAOXXXXXXXXXXXXXXXXXGAOOOXXXXXXXXXXXXXXXXXGAXOOOAXXXXXXXXXXXXXXXGOOOOOOOOAXXXXXXXXXXXXGXXXXXXXXXXXXXXXXXXXXXGOXXXXXXXXXXXXXXXXXXXX,0,463,137
16191,42,8,34,186,236,0,0,407,317,90,GAXXXXXXXXXXXXXXXXXXXXGOAXXXXXXXXXXXXXXXXXXXGAXXXXXXXXXXXXXXXXXXXXGOXXXXXXXXXXXXXXXXXXXXGOXXXXXXXXXXXXXXXXXXXXGOXXXXXXXXXXXXXXXXXXXXGOXXXXXXXXXXXXXXXXXXXXGXXAOXXXXXXXXXXXXXXXXXGAOOOXXXXXXXXXXXXXXXXXGAXOOOAXXXXXXXXXXXXXXXGOOOOOOOOAXXXXXXXXXXXXGXXXXXXXXXXXXXXXXXXXXXGOXXXXXXXXXXXXXXXXXXXX,0,463,137
16212,42,8,34,186,235,0,0,407,319,88,GAXXXXXXXXXXXXXXXXXXXXGOAXXXXXXXXXXXXXXXXXXXGAXXXXXXXXXXXXXXXXXXXXGOXXXXXXXXXXXXXXXXXXXXGOXXXXXXXXXXXXXXXXXXXXGOXXXXXXXXXXXXXXXXXXXXGOXXXXXXXXXXXXXXXXXXXXGAXXOXXXXXXXXXXXXXXXXXGAOOOXXXXXXXXXXXXXXXXXGAXOOOAXXXXXXXXXXXXXXXGOOOOOOOOAXXXXXXXXXXXXGXXXXXXXXXXXXXXXXXXXXXGOXXXXXXXXXXXXXXXXXXXX,0,462,138
16233,42,7,35,184,237,0,0,410,324,86,GAXXXXXXXXXXXXXXXXXXXXGOAXXXXXXXXXXXXXXXXXXXGOXXXXXXXXXXXXXXXXXXXXGOXXXXXXXXXXXXXXXXXXXXGOXXXXXXXXXXXXXXXXXXXXGOXXXXXXXXXXXXXXXXXXXXGOXXXXXXXXXXXXXXXXXXXXGAXXOXXXXXXXXXXXXXXXXXGAOOOXXXXXXXXXXXXXXXXXGAXOOOAXXXXXXXXXXXXXXXGOOOOOOOOAXXXXXXXXXXXXGXXXXXXXXXXXXXXXXXXXXXGOXXXXXXXXXXXXXXXXXXXX,0,462,138
16254,42,7,35,183,238,0,0,409,324,85,GAXXXXXXXXXXXXXXXXXXXXGOAXXXXXXXXXXXXXXXXXXXGOXXXXXXXXXXXXXXXXXXXXGOXXXXXXXXXXXXXXXXXXXXGOXXXXXXXXXXXXXXXXXXXXGOXXXXXXXXXXXXXXXXXXXXGOXXXXXXXXXXXXXXXXXXXXGAXXOXXXXXXXXXXXXXXXXXGAOOOXXXXXXXXXXXXXXXXXGAXOOOAXXXXXXXXXXXXXXXGOOOOOOOOAXXXXXXXXXXXXGXXXXXXXXXXXXXXXXXXXXXGOXXXXXXXXXXXXXXXXXXXX,0,462,138

16275,42,6,36,188,233,0,0,407,324,83,GAXXXXXXXXXXXXXXXXXXXXGOAXXXXXXXXXXXXXXXXXXXGOXXXXXXXXXXXXXXXXXXXXGOXXXXXXXXXXXXXXXXXXXXGOXXXXXXXXXXXXXXXXXXXXGOXXXXXXXXXXXXXXXXXXXXGOXXXXXXXXXXXXXXXXXXXXGOXXOXXXXXXXXXXXXXXXXXGAOOOXXXXXXXXXXXXXXXXXGAXOOOAXXXXXXXXXXXXXXXGOOOOOOOOAXXXXXXXXXXXXGXXXXXXXXXXXXXXXXXXXXXGOXXXXXXXXXXXXXXXXXXXX,0,462,138
16296,43,7,36,187,233,0,0,406,323,83,GAXXXXXXXXXXXXXXXXXXXXGOAXXXXXXXXXXXXXXXXXXXGOXXXXXXXXXXXXXXXXXXXXGOXXXXXXXXXXXXXXXXXXXXGOXXXXXXXXXXXXXXXXXXXXGOAXXXXXXXXXXXXXXXXXXXGOXXXXXXXXXXXXXXXXXXXXGOXXOXXXXXXXXXXXXXXXXXGAOOOXXXXXXXXXXXXXXXXXGAXOOOAXXXXXXXXXXXXXXXGOOOOOOOOAXXXXXXXXXXXXGXXXXXXXXXXXXXXXXXXXXXGOXXXXXXXXXXXXXXXXXXXX,0,462,138
16317,43,7,36,191,229,0,0,403,322,81,GAXXXXXXXXXXXXXXXXXXXXGOAXXXXXXXXXXXXXXXXXXXGOXXXXXXXXXXXXXXXXXXXXGOXXXXXXXXXXXXXXXXXXXXGOXXXXXXXXXXXXXXXXXXXXGOAXXXXXXXXXXXXXXXXXXXGOXXXXXXXXXXXXXXXXXXXXGOXXOXXXXXXXXXXXXXXXXXGAOOOXXXXXXXXXXXXXXXXXGAXOOOAXXXXXXXXXXXXXXXGOOOOOOOOAXXXXXXXXXXXXGXXXXXXXXXXXXXXXXXXXXXGOXXXXXXXXXXXXXXXXXXXX,0,462,138
16338,45,9,36,190,228,0,0,402,324,78,GAXXXXXXXXXXXXXXXXXXXXGOAXXXXXXXXXXXXXXXXXXXGOXXXXXXXXXXXXXXXXXXXXGOXXXXXXXXXXXXXXXXXXXXGOXXXXXXXXXXXXXXXXXXXXGOAXXXXXXXXXXXXXXXXXXXGOXXXXXXXXXXXXXXXXXXXXGOXXOXXXXXXXXXXXXXXXXXGAOOOXXXXXXXXXXXXXXXXXGAXOOOAXXXXXXXXXXXXXXXGOOOOOOOOAAAXXXXXXXXXXGXXXXXXXXXXXXXXXXXXXXXGOXXXXXXXXXXXXXXXXXXXX,0,462,138
16359,46,10,36,189,228,0,0,401,325,76,GAXXXXXXXXXXXXXXXXXXXXGOAXXXXXXXXXXXXXXXXXXXGOXXXXXXXXXXXXXXXXXXXXGOXXXXXXXXXXXXXXXXXXXXGOXXXXXXXXXXXXXXXXXXXXGOAXXXXXXXXXXXXXXXXXXXGOXXXXXXXXXXXXXXXXXXXXGOXXOXXXXXXXXXXXXXXXXXGAOOOXXXXXXXXXXXXXXXXXGAXOOOAXXXXXXXXXXXXXXXGOOOOOOOOAAAXXXXXXXXXXGAXXXXXXXXXXXXXXXXXXXXGOXXXXXXXXXXXXXXXXXXXX,0,462,138

16380,47,9,38,185,231,0,0,408,329,79,GAXXXXXXXXXXXXXXXXXXXXGOAXXXXXXXXXXXXXXXXXXXGOXXXXXXXXXXXXXXXXXXXXGOXXXXXXXXXXXXXXXXXXXXGOXXXXXXXXXXXXXXXXXXXXGOAXXXXXXXXXXXXXXXXXXXGOXXXXXXXXXXXXXXXXXXXXGOXXOXXXXXXXXXXXXXXXXXGAOOOXXXXXXXXXXXXXXXXXGOXOOOOXXXXXXXXXXXXXXXGOOOOOOOOAAAAXXXXXXXXXGAXXXXXXXXXXXXXXXXXXXXGOXXXXXXXXXXXXXXXXXXXX,0,462,138
16401,47,9,38,182,234,0,0,410,333,77,GAXXXXXXXXXXXXXXXXXXXXGOAXXXXXXXXXXXXXXXXXXXGOXXXXXXXXXXXXXXXXXXXXGOXXXXXXXXXXXXXXXXXXXXGOXXXXXXXXXXXXXXXXXXXXGOAXXXXXXXXXXXXXXXXXXXGOXXXXXXXXXXXXXXXXXXXXGOXXOXXXXXXXXXXXXXXXXXGAOOOXXXXXXXXXXXXXXXXXGOXOOOOXXXXXXXXXXXXXXXGOOOOOOOOAAAAXXXXXXXXXGAXXXXXXXXXXXXXXXXXXXXGOXXXXXXXXXXXXXXXXXXXX,0,462,138
16422,47,9,38,183,232,0,0,408,335,73,GAXXXXXXXXXXXXXXXXXXXXGOOXXXXXXXXXXXXXXXXXXXGOXXXXXXXXXXXXXXXXXXXXGOXXXXXXXXXXXXXXXXXXXXGOXXXXXXXXXXXXXXXXXXXXGOAXXXXXXXXXXXXXXXXXXXGOXXXXXXXXXXXXXXXXXXXXGOAXOXXXXXXXXXXXXXXXXXGAOOOXXXXXXXXXXXXXXXXXGOXOOOOXXXXXXXXXXXXXXXGOOOOOXOOAAAAXXXXXXXXXGAXXXXXXXXXXXXXXXXXXXXGOXXXXXXXXXXXXXXXXXXXX,0,461,139
16443,42,6,36,180,240,0,0,415,337,78,GAXXXXXXXXXXXXXXXXXXXXGOOXXXXXXXXXXXXXXXXXXXGOXXXXXXXXXXXXXXXXXXXXGOXXXXXXXXXXXXXXXXXXXXGOXXXXXXXXXXXXXXXXXXXXGOAXXXXXXXXXXXXXXXXXXXGOXXXXXXXXXXXXXXXXXXXXGOAXOXXXXXXXXXXXXXXXXXGAOOOAXXXXXXXXXXXXXXXXGOXOOOOXXXXXXXXXXXXXXXGOOOOOXXXXXXXXXXXXXXXXGAXXXXXXXXXXXXXXXXXXXXGOXXXXXXXXXXXXXXXXXXXX,0,461,139
16464,42,6,36,185,235,0,0,410,334,76,GAXXXXXXXXXXXXXXXXXXXXGOOXXXXXXXXXXXXXXXXXXXGOXXXXXXXXXXXXXXXXXXXXGOXXXXXXXXXXXXXXXXXXXXGOXXXXXXXXXXXXXXXXXXXXGOAXXXXXXXXXXXXXXXXXXXGOXXXXXXXXXXXXXXXXXXXXGOAXOXXXXXXXXXXXXXXXXXGAOOOAXXXXXXXXXXXXXXXXGOXOOOOXXXXXXXXXXXXXXXGOOOOOXXXXXXXXXXXXXXXXGAXXXXXXXXXXXXXXXXXXXXGOXXXXXXXXXXXXXXXXXXXX,0,461,139

16485,42,6,36,188,232,0,0,408,333,75,GAXXXXXXXXXXXXXXXXXXXXGOOXXXXXXXXXXXXXXXXXXXGOXXXXXXXXXXXXXXXXXXXXGOXXXXXXXXXXXXXXXXXXXXGOXXXXXXXXXXXXXXXXXXXXGOAXXXXXXXXXXXXXXXXXXXGOXXXXXXXXXXXXXXXXXXXXGOAXOXXXXXXXXXXXXXXXXXGAOOOAXXXXXXXXXXXXXXXXGOXOOOOXXXXXXXXXXXXXXXGOOOOOXXXXXXXXXXXXXXXXGAXXXXXXXXXXXXXXXXXXXXGOXXXXXXXXXXXXXXXXXXXX,0,461,139
16506,43,7,36,187,232,0,0,408,332,76,GAXXXXXXXXXXXXXXXXXXXXGOOXXXXXXXXXXXXXXXXXXXGOXXXXXXXXXXXXXXXXXXXXGOXXXXXXXXXXXXXXXXXXXXGOXXXXXXXXXXXXXXXXXXXXGOAXXXXXXXXXXXXXXXXXXXGOXXXXXXXXXXXXXXXXXXXXGOAXOXXXXXXXXXXXXXXXXXGAOOOAXXXXXXXXXXXXXXXXGOXOOOOAXXXXXXXXXXXXXXGOOOOOXXXXXXXXXXXXXXXXGAXXXXXXXXXXXXXXXXXXXXGOXXXXXXXXXXXXXXXXXXXX,0,461,139
16527,42,7,35,191,228,0,0,404,325,79,GAXXXXXXXXXXXXXXXXXXXXGOOXXXXXXXXXXXXXXXXXXXGOXXXXXXXXXXXXXXXXXXXXGOXXXXXXXXXXXXXXXXXXXXGOXXXXXXXXXXXXXXXXXXXXGXAXXXXXXXXXXXXXXXXXXXGOXXXXXXXXXXXXXXXXXXXXGOAXOXXXXXXXXXXXXXXXXXGAOOOAXXXXXXXXXXXXXXXXGOXOOOOAXXXXXXXXXXXXXXGOOOOOXXXXXXXXXXXXXXXXGAXXXXXXXXXXXXXXXXXXXXGOXXXXXXXXXXXXXXXXXXXX,0,460,140
16548,42,6,36,186,233,0,0,410,325,85,GAXXXXXXXXXXXXXXXXXXXXGOOXXXXXXXXXXXXXXXXXXXGOXXXXXXXXXXXXXXXXXXXXGOXXXXXXXXXXXXXXXXXXXXGOXXXXXXXXXXXXXXXXXXXXGXAXXXXXXXXXXXXXXXXXXXGOXXXXXXXXXXXXXXXXXXXXGOAXOXXXXXXXXXXXXXXXXXGOOOOAXXXXXXXXXXXXXXXXGOXOOOOAXXXXXXXXXXXXXXGOOOOOXXXXXXXXXXXXXXXXGAXXXXXXXXXXXXXXXXXXXXGOXXXXXXXXXXXXXXXXXXXX,0,460,140
16569,42,6,36,187,232,0,0,409,323,86,GAXXXXXXXXXXXXXXXXXXXXGOOXXXXXXXXXXXXXXXXXXXGOXXXXXXXXXXXXXXXXXXXXGOXXXXXXXXXXXXXXXXXXXXGOXXXXXXXXXXXXXXXXXXXXGXXXXXXXXXXXXXXXXXXXXXGOXXXXXXXXXXXXXXXXXXXXGOAXOXXXXXXXXXXXXXXXXXGOOOOAXXXXXXXXXXXXXXXXGOXOOOOAXXXXXXXXXXXXXXGOOOOOAXXXXXXXXXXXXXXXGAXXXXXXXXXXXXXXXXXXXXGOXXXXXXXXXXXXXXXXXXXX,0,460,140

16590,41,6,35,187,232,0,0,406,321,85,GAXXXXXXXXXXXXXXXXXXXXGOOXXXXXXXXXXXXXXXXXXXGOXXXXXXXXXXXXXXXXXXXXGOXXXXXXXXXXXXXXXXXXXXGOXXXXXXXXXXXXXXXXXXXXGXXXXXXXXXXXXXXXXXXXXXGXXXXXXXXXXXXXXXXXXXXXGOAXOXXXXXXXXXXXXXXXXXGOOOOAXXXXXXXXXXXXXXXXGOXOOOOAXXXXXXXXXXXXXXGOOOOOAXXXXXXXXXXXXXXXGAXXXXXXXXXXXXXXXXXXXXGOXXXXXXXXXXXXXXXXXXXX,0,459,141
16611,41,6,35,188,231,0,0,408,322,86,GAXXXXXXXXXXXXXXXXXXXXGOOXXXXXXXXXXXXXXXXXXXGOXXXXXXXXXXXXXXXXXXXXGOXXXXXXXXXXXXXXXXXXXXGOXXXXXXXXXXXXXXXXXXXXGXXXXXXXXXXXXXXXXXXXXXGXXXXXXXXXXXXXXXXXXXXXGOAXOXXXXXXXXXXXXXXXXXGOOOOAXXXXXXXXXXXXXXXXGOXOOOOAXXXXXXXXXXXXXXGOOOOOAXXXXXXXXXXXXXXXGAXXXXXXXXXXXXXXXXXXXXGOXXXXXXXXXXXXXXXXXXXX,0,459,141
16632,41,4,37,187,232,0,0,411,325,86,GOXXXXXXXXXXXXXXXXXXXXGOOXXXXXXXXXXXXXXXXXXXGOXXXXXXXXXXXXXXXXXXXXGOXXXXXXXXXXXXXXXXXXXXGOXXXXXXXXXXXXXXXXXXXXGXXXXXXXXXXXXXXXXXXXXXGXXXXXXXXXXXXXXXXXXXXXGOAXOXXXXXXXXXXXXXXXXXGOOOOAXXXXXXXXXXXXXXXXGOXOOOOAXXXXXXXXXXXXXXGOOOOOAXXXXXXXXXXXXXXXGOXXXXXXXXXXXXXXXXXXXXGOXXXXXXXXXXXXXXXXXXXX,0,459,141
16653,41,4,37,189,230,0,0,409,320,89,GOXXXXXXXXXXXXXXXXXXXXGOOXXXXXXXXXXXXXXXXXXXGOXXXXXXXXXXXXXXXXXXXXGOXXXXXXXXXXXXXXXXXXXXGOXXXXXXXXXXXXXXXXXXXXGXXXXXXXXXXXXXXXXXXXXXGXXXXXXXXXXXXXXXXXXXXXGOAXOXXXXXXXXXXXXXXXXXGOOOOAXXXXXXXXXXXXXXXXGOXOOOOAXXXXXXXXXXXXXXGOOOOOAXXXXXXXXXXXXXXXGOXXXXXXXXXXXXXXXXXXXXGOXXXXXXXXXXXXXXXXXXXX,0,459,141
16674,42,5,37,182,236,0,0,413,324,89,GOXXXXXXXXXXXXXXXXXXXXGOOXXXXXXXXXXXXXXXXXXXGOXXXXXXXXXXXXXXXXXXXXGOXXXXXXXXXXXXXXXXXXXXGOXXXXXXXXXXXXXXXXXXXXGXXXXXXXXXXXXXXXXXXXXXGXXXXXXXXXXXXXXXXXXXXXGOAXOXXXXXXXXXXXXXXXXXGOOOOAAXXXXXXXXXXXXXXXGOXOOOOAXXXXXXXXXXXXXXGOOOOOAXXXXXXXXXXXXXXXGOXXXXXXXXXXXXXXXXXXXXGOXXXXXXXXXXXXXXXXXXXX,0,459,141

16695,43,6,37,177,240,0,0,418,327,91,GOXXXXXXXXXXXXXXXXXXXXGOOXXXXXXXXXXXXXXXXXXXGOXXXXXXXXXXXXXXXXXXXXGOXXXXXXXXXXXXXXXXXXXXGOXXXXXXXXXXXXXXXXXXXXGXXXXXXXXXXXXXXXXXXXXXGXXXXXXXXXXXXXXXXXXXXXGOAXOXXXXXXXXXXXXXXXXXGOOOOAAXXXXXXXXXXXXXXXGOXOOOOAAXXXXXXXXXXXXXGOOOOOAXXXXXXXXXXXXXXXGOXXXXXXXXXXXXXXXXXXXXGOXXXXXXXXXXXXXXXXXXXX,0,459,141
16716,44,7,37,179,237,0,0,415,326,89,GOXXXXXXXXXXXXXXXXXXXXGOOXXXXXXXXXXXXXXXXXXXGOXXXXXXXXXXXXXXXXXXXXGOXXXXXXXXXXXXXXXXXXXXGOXXXXXXXXXXXXXXXXXXXXGXXXXXXXXXXXXXXXXXXXXXGAXXXXXXXXXXXXXXXXXXXXGOAXOXXXXXXXXXXXXXXXXXGOOOOAAXXXXXXXXXXXXXXXGOXOOOOAAXXXXXXXXXXXXXGOOOOOAXXXXXXXXXXXXXXXGOXXXXXXXXXXXXXXXXXXXXGOXXXXXXXXXXXXXXXXXXXX,0,459,141
16737,45,8,37,177,238,0,0,416,327,89,GOXXXXXXXXXXXXXXXXXXXXGOOXXXXXXXXXXXXXXXXXXXGOXXXXXXXXXXXXXXXXXXXXGOXXXXXXXXXXXXXXXXXXXXGOXXXXXXXXXXXXXXXXXXXXGXXXXXXXXXXXXXXXXXXXXXGAXXXXXXXXXXXXXXXXXXXXGOAXOXXXXXXXXXXXXXXXXXGOOOOAAXXXXXXXXXXXXXXXGOXOOOOAAXXXXXXXXXXXXXGOOOOOAAXXXXXXXXXXXXXXGOXXXXXXXXXXXXXXXXXXXXGOXXXXXXXXXXXXXXXXXXXX,0,459,141
16758,46,9,37,177,237,0,0,415,324,91,GOXXXXXXXXXXXXXXXXXXXXGOOXXXXXXXXXXXXXXXXXXXGOXXXXXXXXXXXXXXXXXXXXGOXXXXXXXXXXXXXXXXXXXXGOXXXXXXXXXXXXXXXXXXXXGXXXXXXXXXXXXXXXXXXXXXGAXXXXXXXXXXXXXXXXXXXXGOAXOXXXXXXXXXXXXXXXXXGOOOOAAXXXXXXXXXXXXXXXGOXOOOOAAAXXXXXXXXXXXXGOOOOOAAXXXXXXXXXXXXXXGOXXXXXXXXXXXXXXXXXXXXGOXXXXXXXXXXXXXXXXXXXX,0,459,141
16779,46,8,38,170,244,0,0,423,324,99,GOXXXXXXXXXXXXXXXXXXXXGOOXXXXXXXXXXXXXXXXXXXGOXXXXXXXXXXXXXXXXXXXXGOXXXXXXXXXXXXXXXXXXXXGOXXXXXXXXXXXXXXXXXXXXGXXXXXXXXXXXXXXXXXXXXXGAXXXXXXXXXXXXXXXXXXXXGOAXOXXXXXXXXXXXXXXXXXGOOOOOAXXXXXXXXXXXXXXXGOXOOOOAAAXXXXXXXXXXXXGOOOOOAAXXXXXXXXXXXXXXGOXXXXXXXXXXXXXXXXXXXXGOXXXXXXXXXXXXXXXXXXXX,0,459,141

16800,47,9,38,171,242,0,0,421,324,97,GOXXXXXXXXXXXXXXXXXXXXGOOAXXXXXXXXXXXXXXXXXXGOXXXXXXXXXXXXXXXXXXXXGOXXXXXXXXXXXXXXXXXXXXGOXXXXXXXXXXXXXXXXXXXXGXXXXXXXXXXXXXXXXXXXXXGAXXXXXXXXXXXXXXXXXXXXGOAXOXXXXXXXXXXXXXXXXXGOOOOOAXXXXXXXXXXXXXXXGOXOOOOAAAXXXXXXXXXXXXGOOOOOAAXXXXXXXXXXXXXXGOXXXXXXXXXXXXXXXXXXXXGOXXXXXXXXXXXXXXXXXXXX,0,459,141
16821,47,9,38,171,242,0,0,420,325,95,GOXXXXXXXXXXXXXXXXXXXXGOOAXXXXXXXXXXXXXXXXXXGOXXXXXXXXXXXXXXXXXXXXGOXXXXXXXXXXXXXXXXXXXXGOXXXXXXXXXXXXXXXXXXXXGXXXXXXXXXXXXXXXXXXXXXGAXXXXXXXXXXXXXXXXXXXXGOAXOXXXXXXXXXXXXXXXXXGOOOOOAXXXXXXXXXXXXXXXGOXOOOOAAAXXXXXXXXXXXXGOOOOOAAXXXXXXXXXXXXXXGOXXXXXXXXXXXXXXXXXXXXGOXXXXXXXXXXXXXXXXXXXX,0,459,141
16842,47,9,38,169,244,0,0,423,323,100,GOXXXXXXXXXXXXXXXXXXXXGOOAXXXXXXXXXXXXXXXXXXGOXXXXXXXXXXXXXXXXXXXXGOXXXXXXXXXXXXXXXXXXXXGOXXXXXXXXXXXXXXXXXXXXGXXXXXXXXXXXXXXXXXXXXXGAXXXXXXXXXXXXXXXXXXXXGOAXOXXXXXXXXXXXXXXXXXGOOOOOAXXXXXXXXXXXXXXXGOXOOOOAAAXXXXXXXXXXXXGOOOOOAAXXXXXXXXXXXXXXGOXXXXXXXXXXXXXXXXXXXXGOXXXXXXXXXXXXXXXXXXXX,0,459,141
16863,47,9,38,169,244,0,0,423,324,99,GOXXXXXXXXXXXXXXXXXXXXGOOAXXXXXXXXXXXXXXXXXXGOXXXXXXXXXXXXXXXXXXXXGOXXXXXXXXXXXXXXXXXXXXGOXXXXXXXXXXXXXXXXXXXXGXXXXXXXXXXXXXXXXXXXXXGAXXXXXXXXXXXXXXXXXXXXGOAXOXXXXXXXXXXXXXXXXXGOOOOOAXXXXXXXXXXXXXXXGOXOOOOAAAXXXXXXXXXXXXGOOOOOAAXXXXXXXXXXXXXXGOXXXXXXXXXXXXXXXXXXXXGOXXXXXXXXXXXXXXXXXXXX,0,459,141
16884,47,9,38,166,247,0,0,425,324,101,GOXXXXXXXXXXXXXXXXXXXXGOOAXXXXXXXXXXXXXXXXXXGOXXXXXXXXXXXXXXXXXXXXGOXXXXXXXXXXXXXXXXXXXXGOXXXXXXXXXXXXXXXXXXXXGXXXXXXXXXXXXXXXXXXXXXGAXXXXXXXXXXXXXXXXXXXXGOAXOXXXXXXXXXXXXXXXXXGOOOOOAXXXXXXXXXXXXXXXGOXOOOOAAAXXXXXXXXXXXXGOOOOOAAXXXXXXXXXXXXXXGOXXXXXXXXXXXXXXXXXXXXGOXXXXXXXXXXXXXXXXXXXX,0,459,141

16905,47,8,39,169,244,0,0,425,326,99,GOXXXXXXXXXXXXXXXXXXXXGOOAXXXXXXXXXXXXXXXXXXGOXXXXXXXXXXXXXXXXXXXXGOXXXXXXXXXXXXXXXXXXXXGOXXXXXXXXXXXXXXXXXXXXGXXXXXXXXXXXXXXXXXXXXXGAXXXXXXXXXXXXXXXXXXXXGOAXOXXXXXXXXXXXXXXXXXGOOOOOAXXXXXXXXXXXXXXXGOXOOOOOAAXXXXXXXXXXXXGOOOOOAAXXXXXXXXXXXXXXGOXXXXXXXXXXXXXXXXXXXXGOXXXXXXXXXXXXXXXXXXXX,0,459,141
16926,47,8,39,165,248,0,0,429,328,101,GOXXXXXXXXXXXXXXXXXXXXGOOAXXXXXXXXXXXXXXXXXXGOXXXXXXXXXXXXXXXXXXXXGOXXXXXXXXXXXXXXXXXXXXGOXXXXXXXXXXXXXXXXXXXXGXXXXXXXXXXXXXXXXXXXXXGAXXXXXXXXXXXXXXXXXXXXGOAXOXXXXXXXXXXXXXXXXXGOOOOOAXXXXXXXXXXXXXXXGOXOOOOOAAXXXXXXXXXXXXGOOOOOAAXXXXXXXXXXXXXXGOXXXXXXXXXXXXXXXXXXXXGOXXXXXXXXXXXXXXXXXXXX,0,459,141
16947,49,10,39,166,245,0,0,426,331,95,GOXXXXXXXXXXXXXXXXXXXXGOOAAXXXXXXXXXXXXXXXXXGOXXXXXXXXXXXXXXXXXXXXGOXXXXXXXXXXXXXXXXXXXXGOXXXXXXXXXXXXXXXXXXXXGXXXXXXXXXXXXXXXXXXXXXGAXXXXXXXXXXXXXXXXXXXXGOAXOXXXXXXXXXXXXXXXXXGOOOOOAXXXXXXXXXXXXXXXGOXOOOOOAAAXXXXXXXXXXXGOOOOOAAXXXXXXXXXXXXXXGOXXXXXXXXXXXXXXXXXXXXGOXXXXXXXXXXXXXXXXXXXX,0,459,141
16968,50,10,40,169,241,0,0,422,326,96,GOXXXXXXXXXXXXXXXXXXXXGOOAOXXXXXXXXXXXXXXXXXGOXXXXXXXXXXXXXXXXXXXXGOAXXXXXXXXXXXXXXXXXXXGOXXXXXXXXXXXXXXXXXXXXGXXXXXXXXXXXXXXXXXXXXXGAXXXXXXXXXXXXXXXXXXXXGOAXOXXXXXXXXXXXXXXXXXGOOOOOAXXXXXXXXXXXXXXXGOXOOOOOAAAXXXXXXXXXXXGOOOOOAAXXXXXXXXXXXXXXGOXXXXXXXXXXXXXXXXXXXXGOXXXXXXXXXXXXXXXXXXXX,0,459,141
16989,50,10,40,169,241,0,0,423,327,96,GOXXXXXXXXXXXXXXXXXXXXGOOAOXXXXXXXXXXXXXXXXXGOXXXXXXXXXXXXXXXXXXXXGOAXXXXXXXXXXXXXXXXXXXGOXXXXXXXXXXXXXXXXXXXXGXXXXXXXXXXXXXXXXXXXXXGAXXXXXXXXXXXXXXXXXXXXGOAXOXXXXXXXXXXXXXXXXXGOOOOOAXXXXXXXXXXXXXXXGOXOOOOOAAAXXXXXXXXXXXGOOOOOAAXXXXXXXXXXXXXXGOXXXXXXXXXXXXXXXXXXXXGOXXXXXXXXXXXXXXXXXXXX,0,459,141

17010,50,10,40,167,243,0,0,425,328,97,GOXXXXXXXXXXXXXXXXXXXXGOOAOXXXXXXXXXXXXXXXXXGOXXXXXXXXXXXXXXXXXXXXGOAXXXXXXXXXXXXXXXXXXXGOXXXXXXXXXXXXXXXXXXXXGXXXXXXXXXXXXXXXXXXXXXGAXXXXXXXXXXXXXXXXXXXXGOAXOXXXXXXXXXXXXXXXXXGOOOOOAXXXXXXXXXXXXXXXGOXOOOOOAAAXXXXXXXXXXXGOOOOOAAXXXXXXXXXXXXXXGOXXXXXXXXXXXXXXXXXXXXGOXXXXXXXXXXXXXXXXXXXX,0,459,141
17031,50,10,40,166,244,0,0,426,330,96,GOXXXXXXXXXXXXXXXXXXXXGOOAOXXXXXXXXXXXXXXXXXGOXXXXXXXXXXXXXXXXXXXXGOAXXXXXXXXXXXXXXXXXXXGOXXXXXXXXXXXXXXXXXXXXGXXXXXXXXXXXXXXXXXXXXXGAXXXXXXXXXXXXXXXXXXXXGOAXOXXXXXXXXXXXXXXXXXGOOOOOAXXXXXXXXXXXXXXXGOXOOOOOAAAXXXXXXXXXXXGOOOOOAAXXXXXXXXXXXXXXGOXXXXXXXXXXXXXXXXXXXXGOXXXXXXXXXXXXXXXXXXXX,0,459,141
17052,51,11,40,162,247,0,0,429,336,93,GOXXXXXXXXXXXXXXXXXXXXGOOAOXXXXXXXXXXXXXXXXXGOXXXXXXXXXXXXXXXXXXXXGOAXXXXXXXXXXXXXXXXXXXGOXXXXXXXXXXXXXXXXXXXXGXXXXXXXXXXXXXXXXXXXXXGAXXXXXXXXXXXXXXXXXXXXGOAXOXXXXXXXXXXXXXXXXXGOOOOOAAXXXXXXXXXXXXXXGOXOOOOOAAAXXXXXXXXXXXGOOOOOAAXXXXXXXXXXXXXXGOXXXXXXXXXXXXXXXXXXXXGOXXXXXXXXXXXXXXXXXXXX,0,459,141
17073,50,10,40,158,251,0,0,433,332,101,GOXXXXXXXXXXXXXXXXXXXXGOOAOXXXXXXXXXXXXXXXXXGOXXXXXXXXXXXXXXXXXXXXGOAXXXXXXXXXXXXXXXXXXXGOXXXXXXXXXXXXXXXXXXXXGXXXXXXXXXXXXXXXXXXXXXGAXXXXXXXXXXXXXXXXXXXXGOAXOXXXXXXXXXXXXXXXXXGOOOOOAAXXXXXXXXXXXXXXGXXOOOOOAOAXXXXXXXXXXXGOOOOOAAXXXXXXXXXXXXXXGOXXXXXXXXXXXXXXXXXXXXGOXXXXXXXXXXXXXXXXXXXX,0,458,142
17094,50,9,41,161,248,0,0,432,332,100,GOXXXXXXXXXXXXXXXXXXXXGOOAOXXXXXXXXXXXXXXXXXGOXXXXXXXXXXXXXXXXXXXXGOAXXXXXXXXXXXXXXXXXXXGOXXXXXXXXXXXXXXXXXXXXGXXXXXXXXXXXXXXXXXXXXXGAXXXXXXXXXXXXXXXXXXXXGOAXOXXXXXXXXXXXXXXXXXGOOOOOOAXXXXXXXXXXXXXXGXXOOOOOAOAXXXXXXXXXXXGOOOOOAAXXXXXXXXXXXXXXGOXXXXXXXXXXXXXXXXXXXXGOXXXXXXXXXXXXXXXXXXXX,0,458,142

17115,50,9,41,169,240,0,0,424,330,94,GOXXXXXXXXXXXXXXXXXXXXGOOAOXXXXXXXXXXXXXXXXXGOXXXXXXXXXXXXXXXXXXXXGOAXXXXXXXXXXXXXXXXXXXGOXXXXXXXXXXXXXXXXXXXXGXXXXXXXXXXXXXXXXXXXXXGAXXXXXXXXXXXXXXXXXXXXGOAXOXXXXXXXXXXXXXXXXXGOOOOOOAXXXXXXXXXXXXXXGXXOOOOOAOAXXXXXXXXXXXGOOOOOAAXXXXXXXXXXXXXXGOXXXXXXXXXXXXXXXXXXXXGOXXXXXXXXXXXXXXXXXXXX,0,458,142
17136,50,9,41,169,240,0,0,423,331,92,GOXXXXXXXXXXXXXXXXXXXXGOOAOXXXXXXXXXXXXXXXXXGOXXXXXXXXXXXXXXXXXXXXGOAXXXXXXXXXXXXXXXXXXXGOXXXXXXXXXXXXXXXXXXXXGXXXXXXXXXXXXXXXXXXXXXGAXXXXXXXXXXXXXXXXXXXXGOAXOXXXXXXXXXXXXXXXXXGOOOOOOAXXXXXXXXXXXXXXGXXOOOOOAOAXXXXXXXXXXXGOOOOOAAXXXXXXXXXXXXXXGOXXXXXXXXXXXXXXXXXXXXGOXXXXXXXXXXXXXXXXXXXX,0,458,142
17157,50,8,42,169,240,0,0,424,334,90,GOXXXXXXXXXXXXXXXXXXXXGOOAOXXXXXXXXXXXXXXXXXGOXXXXXXXXXXXXXXXXXXXXGOOXXXXXXXXXXXXXXXXXXXGOXXXXXXXXXXXXXXXXXXXXGXXXXXXXXXXXXXXXXXXXXXGAXXXXXXXXXXXXXXXXXXXXGOAXOXXXXXXXXXXXXXXXXXGOOOOOOAXXXXXXXXXXXXXXGXXOOOOOAOAXXXXXXXXXXXGOOOOOAAXXXXXXXXXXXXXXGOXXXXXXXXXXXXXXXXXXXXGOXXXXXXXXXXXXXXXXXXXX,0,458,142
17178,50,8,42,170,239,0,0,422,337,85,GOXXXXXXXXXXXXXXXXXXXXGOOAOXXXXXXXXXXXXXXXXXGOXXXXXXXXXXXXXXXXXXXXGOOXXXXXXXXXXXXXXXXXXXGOXXXXXXXXXXXXXXXXXXXXGXXXXXXXXXXXXXXXXXXXXXGAXXXXXXXXXXXXXXXXXXXXGOAXOXXXXXXXXXXXXXXXXXGOOOOOOAXXXXXXXXXXXXXXGXXOOOOOAOAXXXXXXXXXXXGOOOOOAAXXXXXXXXXXXXXXGOXXXXXXXXXXXXXXXXXXXXGOXXXXXXXXXXXXXXXXXXXX,0,458,142
17199,49,8,41,171,238,0,0,420,338,82,GOXXXXXXXXXXXXXXXXXXXXGOOAOXXXXXXXXXXXXXXXXXGOXXXXXXXXXXXXXXXXXXXXGOOXXXXXXXXXXXXXXXXXXXGOXXXXXXXXXXXXXXXXXXXXGXXXXXXXXXXXXXXXXXXXXXGAXXXXXXXXXXXXXXXXXXXXGOAXOXXXXXXXXXXXXXXXXXGOOOOOOAXXXXXXXXXXXXXXGXXOOOOOAOAXXXXXXXXXXXGXOOOOAAXXXXXXXXXXXXXXGOXXXXXXXXXXXXXXXXXXXXGOXXXXXXXXXXXXXXXXXXXX,0,457,143

17220,29,4,25,174,255,0,0,423,342,81,GOXXXXXXXXXXXXXXXXXXXXGOOAOXXXXXXXXXXXXXXXXXGOXXXXXXXXXXXXXXXXXXXXGOOXXXXXXXXXXXXXXXXXXXGOXXXXXXXXXXXXXXXXXXXXGXXXXXXXXXXXXXXXXXXXXXGAXXXXXXXXXXXXXXXXXXXXGOAAXXXXXXXXXXXXXXXXXXGOXXXXXXXXXXXXXXXXXXXXGXXXXXXXXXXXXXXXXXXXXXGXXXXXXXXXXXXXXXXXXXXXGOXXXXXXXXXXXXXXXXXXXXGOXXXXXXXXXXXXXXXXXXXX,0,457,143
17241,30,5,25,170,258,0,0,426,348,78,GOXXXXXXXXXXXXXXXXXXXXGOOAOXXXXXXXXXXXXXXXXXGOXXXXXXXXXXXXXXXXXXXXGOOXXXXXXXXXXXXXXXXXXXGOXXXXXXXXXXXXXXXXXXXXGXXXXXXXXXXXXXXXXXXXXXGAXXXXXXXXXXXXXXXXXXXXGOAAXXXXXXXXXXXXXXXXXXGOXXXXXXXXXXXXXXXXXXXXGAXXXXXXXXXXXXXXXXXXXXGXXXXXXXXXXXXXXXXXXXXXGOXXXXXXXXXXXXXXXXXXXXGOXXXXXXXXXXXXXXXXXXXX,0,457,143
17262,30,5,25,169,259,0,0,427,351,76,GOXXXXXXXXXXXXXXXXXXXXGOOAOXXXXXXXXXXXXXXXXXGOXXXXXXXXXXXXXXXXXXXXGOOXXXXXXXXXXXXXXXXXXXGOXXXXXXXXXXXXXXXXXXXXGXXXXXXXXXXXXXXXXXXXXXGAXXXXXXXXXXXXXXXXXXXXGOAAXXXXXXXXXXXXXXXXXXGOXXXXXXXXXXXXXXXXXXXXGAXXXXXXXXXXXXXXXXXXXXGXXXXXXXXXXXXXXXXXXXXXGOXXXXXXXXXXXXXXXXXXXXGOXXXXXXXXXXXXXXXXXXXX,0,457,143
17283,30,5,25,168,260,0,0,428,349,79,GOXXXXXXXXXXXXXXXXXXXXGOOAOXXXXXXXXXXXXXXXXXGOXXXXXXXXXXXXXXXXXXXXGOOXXXXXXXXXXXXXXXXXXXGOXXXXXXXXXXXXXXXXXXXXGXXXXXXXXXXXXXXXXXXXXXGAXXXXXXXXXXXXXXXXXXXXGOAAXXXXXXXXXXXXXXXXXXGOXXXXXXXXXXXXXXXXXXXXGAXXXXXXXXXXXXXXXXXXXXGXXXXXXXXXXXXXXXXXXXXXGOXXXXXXXXXXXXXXXXXXXXGOXXXXXXXXXXXXXXXXXXXX,0,457,143
17304,29,5,24,174,254,0,0,422,342,80,GOXXXXXXXXXXXXXXXXXXXXGOOAOXXXXXXXXXXXXXXXXXGOXXXXXXXXXXXXXXXXXXXXGOOXXXXXXXXXXXXXXXXXXXGOXXXXXXXXXXXXXXXXXXXXGXXXXXXXXXXXXXXXXXXXXXGAXXXXXXXXXXXXXXXXXXXXGXAAXXXXXXXXXXXXXXXXXXGOXXXXXXXXXXXXXXXXXXXXGAXXXXXXXXXXXXXXXXXXXXGXXXXXXXXXXXXXXXXXXXXXGOXXXXXXXXXXXXXXXXXXXXGOXXXXXXXXXXXXXXXXXXXX,0,456,144

17325,29,5,24,175,253,0,0,421,340,81,GOXXXXXXXXXXXXXXXXXXXXGOOAOXXXXXXXXXXXXXXXXXGOXXXXXXXXXXXXXXXXXXXXGOOXXXXXXXXXXXXXXXXXXXGOXXXXXXXXXXXXXXXXXXXXGXXXXXXXXXXXXXXXXXXXXXGAXXXXXXXXXXXXXXXXXXXXGXAAXXXXXXXXXXXXXXXXXXGOXXXXXXXXXXXXXXXXXXXXGAXXXXXXXXXXXXXXXXXXXXGXXXXXXXXXXXXXXXXXXXXXGOXXXXXXXXXXXXXXXXXXXXGOXXXXXXXXXXXXXXXXXXXX,0,456,144
17346,29,5,24,175,253,0,0,421,338,83,GOXXXXXXXXXXXXXXXXXXXXGOOAOXXXXXXXXXXXXXXXXXGOXXXXXXXXXXXXXXXXXXXXGOOXXXXXXXXXXXXXXXXXXXGOXXXXXXXXXXXXXXXXXXXXGXXXXXXXXXXXXXXXXXXXXXGAXXXXXXXXXXXXXXXXXXXXGXAAXXXXXXXXXXXXXXXXXXGOXXXXXXXXXXXXXXXXXXXXGAXXXXXXXXXXXXXXXXXXXXGXXXXXXXXXXXXXXXXXXXXXGOXXXXXXXXXXXXXXXXXXXXGOXXXXXXXXXXXXXXXXXXXX,0,456,144
17367,29,5,24,175,253,0,0,421,337,84,GOXXXXXXXXXXXXXXXXXXXXGOOAOXXXXXXXXXXXXXXXXXGOXXXXXXXXXXXXXXXXXXXXGOOXXXXXXXXXXXXXXXXXXXGOXXXXXXXXXXXXXXXXXXXXGXXXXXXXXXXXXXXXXXXXXXGAXXXXXXXXXXXXXXXXXXXXGXAAXXXXXXXXXXXXXXXXXXGOXXXXXXXXXXXXXXXXXXXXGAXXXXXXXXXXXXXXXXXXXXGXXXXXXXXXXXXXXXXXXXXXGOXXXXXXXXXXXXXXXXXXXXGOXXXXXXXXXXXXXXXXXXXX,0,456,144
17388,29,5,24,179,249,0,0,417,330,87,GOXXXXXXXXXXXXXXXXXXXXGOOAOXXXXXXXXXXXXXXXXXGOXXXXXXXXXXXXXXXXXXXXGOOXXXXXXXXXXXXXXXXXXXGOXXXXXXXXXXXXXXXXXXXXGXXXXXXXXXXXXXXXXXXXXXGAXXXXXXXXXXXXXXXXXXXXGXAAXXXXXXXXXXXXXXXXXXGOXXXXXXXXXXXXXXXXXXXXGAXXXXXXXXXXXXXXXXXXXXGXXXXXXXXXXXXXXXXXXXXXGOXXXXXXXXXXXXXXXXXXXXGOXXXXXXXXXXXXXXXXXXXX,0,456,144
17409,29,5,24,182,246,0,0,414,328,86,GOXXXXXXXXXXXXXXXXXXXXGOOAOXXXXXXXXXXXXXXXXXGOXXXXXXXXXXXXXXXXXXXXGOOXXXXXXXXXXXXXXXXXXXGOXXXXXXXXXXXXXXXXXXXXGXXXXXXXXXXXXXXXXXXXXXGAXXXXXXXXXXXXXXXXXXXXGXAAXXXXXXXXXXXXXXXXXXGOXXXXXXXXXXXXXXXXXXXXGAXXXXXXXXXXXXXXXXXXXXGXXXXXXXXXXXXXXXXXXXXXGOXXXXXXXXXXXXXXXXXXXXGOXXXXXXXXXXXXXXXXXXXX,0,456,144

17430,28,5,23,185,243,0,0,411,327,84,GOXXXXXXXXXXXXXXXXXXXXGOOAOXXXXXXXXXXXXXXXXXGOXXXXXXXXXXXXXXXXXXXXGOOXXXXXXXXXXXXXXXXXXXGXXXXXXXXXXXXXXXXXXXXXGXXXXXXXXXXXXXXXXXXXXXGAXXXXXXXXXXXXXXXXXXXXGXAAXXXXXXXXXXXXXXXXXXGOXXXXXXXXXXXXXXXXXXXXGAXXXXXXXXXXXXXXXXXXXXGXXXXXXXXXXXXXXXXXXXXXGOXXXXXXXXXXXXXXXXXXXXGOXXXXXXXXXXXXXXXXXXXX,0,455,145
17451,27,5,22,181,247,0,0,415,330,85,GOXXXXXXXXXXXXXXXXXXXXGOOAOXXXXXXXXXXXXXXXXXGOXXXXXXXXXXXXXXXXXXXXGOXXXXXXXXXXXXXXXXXXXXGXXXXXXXXXXXXXXXXXXXXXGXXXXXXXXXXXXXXXXXXXXXGAXXXXXXXXXXXXXXXXXXXXGXAAXXXXXXXXXXXXXXXXXXGOXXXXXXXXXXXXXXXXXXXXGAXXXXXXXXXXXXXXXXXXXXGXXXXXXXXXXXXXXXXXXXXXGOXXXXXXXXXXXXXXXXXXXXGOXXXXXXXXXXXXXXXXXXXX,0,454,146
17472,27,4,23,174,254,0,0,423,335,88,GOXXXXXXXXXXXXXXXXXXXXGOOAOXXXXXXXXXXXXXXXXXGOXXXXXXXXXXXXXXXXXXXXGOXXXXXXXXXXXXXXXXXXXXGXXXXXXXXXXXXXXXXXXXXXGXXXXXXXXXXXXXXXXXXXXXGAXXXXXXXXXXXXXXXXXXXXGXAAXXXXXXXXXXXXXXXXXXGOXXXXXXXXXXXXXXXXXXXXGOXXXXXXXXXXXXXXXXXXXXGXXXXXXXXXXXXXXXXXXXXXGOXXXXXXXXXXXXXXXXXXXXGOXXXXXXXXXXXXXXXXXXXX,0,454,146
17493,27,4,23,176,252,0,0,421,336,85,GOXXXXXXXXXXXXXXXXXXXXGOOAOXXXXXXXXXXXXXXXXXGOXXXXXXXXXXXXXXXXXXXXGOXXXXXXXXXXXXXXXXXXXXGXXXXXXXXXXXXXXXXXXXXXGXXXXXXXXXXXXXXXXXXXXXGAXXXXXXXXXXXXXXXXXXXXGXAAXXXXXXXXXXXXXXXXXXGOXXXXXXXXXXXXXXXXXXXXGOXXXXXXXXXXXXXXXXXXXXGXXXXXXXXXXXXXXXXXXXXXGOXXXXXXXXXXXXXXXXXXXXGOXXXXXXXXXXXXXXXXXXXX,0,454,146
17514,28,6,22,175,251,0,0,420,331,89,GOXXXXXXXXXXXXXXXXXXXXGOXAOXXXXXXXXXXXXXXXXXGOXXXXXXXXXXXXXXXXXXXXGOXXXXXXXXXXXXXXXXXXXXGXXXXXXXXXXXXXXXXXXXXXGXXXXXXXXXXXXXXXXXXXXXGAXXXXXXXXXXXXXXXXXXXXGXAAAAXXXXXXXXXXXXXXXXGOXXXXXXXXXXXXXXXXXXXXGOXXXXXXXXXXXXXXXXXXXXGXXXXXXXXXXXXXXXXXXXXXGOXXXXXXXXXXXXXXXXXXXXGOXXXXXXXXXXXXXXXXXXXX,0,453,147

17535,26,5,21,177,251,0,0,419,332,87,GOXXXXXXXXXXXXXXXXXXXXGOXXXXXXXXXXXXXXXXXXXXGOXXXXXXXXXXXXXXXXXXXXGOXXXXXXXXXXXXXXXXXXXXGXXXXXXXXXXXXXXXXXXXXXGXXXXXXXXXXXXXXXXXXXXXGAXXXXXXXXXXXXXXXXXXXXGXAAAAXXXXXXXXXXXXXXXXGOXXXXXXXXXXXXXXXXXXXXGOXXXXXXXXXXXXXXXXXXXXGXXXXXXXXXXXXXXXXXXXXXGOXXXXXXXXXXXXXXXXXXXXGOXXXXXXXXXXXXXXXXXXXX,0,453,147
17556,27,6,21,174,253,0,0,420,336,84,GOXXXXXXXXXXXXXXXXXXXXGOXXXXXXXXXXXXXXXXXXXXGOXXXXXXXXXXXXXXXXXXXXGOXXXXXXXXXXXXXXXXXXXXGXXXXXXXXXXXXXXXXXXXXXGXXXXXXXXXXXXXXXXXXXXXGAXXXXXXXXXXXXXXXXXXXXGAAAAAXXXXXXXXXXXXXXXXGOXXXXXXXXXXXXXXXXXXXXGOXXXXXXXXXXXXXXXXXXXXGXXXXXXXXXXXXXXXXXXXXXGOXXXXXXXXXXXXXXXXXXXXGOXXXXXXXXXXXXXXXXXXXX,0,453,147
17577,27,6,21,180,247,0,0,415,333,82,GOXXXXXXXXXXXXXXXXXXXXGOXXXXXXXXXXXXXXXXXXXXGOXXXXXXXXXXXXXXXXXXXXGOXXXXXXXXXXXXXXXXXXXXGXXXXXXXXXXXXXXXXXXXXXGXXXXXXXXXXXXXXXXXXXXXGAXXXXXXXXXXXXXXXXXXXXGAAAAAXXXXXXXXXXXXXXXXGOXXXXXXXXXXXXXXXXXXXXGOXXXXXXXXXXXXXXXXXXXXGXXXXXXXXXXXXXXXXXXXXXGOXXXXXXXXXXXXXXXXXXXXGOXXXXXXXXXXXXXXXXXXXX,0,453,147
17598,29,8,21,181,244,0,0,412,334,78,GOXXXXXXXXXXXXXXXXXXXXGOXXXXXXXXXXXXXXXXXXXXGOXXXXXXXXXXXXXXXXXXXXGOXXXXXXXXXXXXXXXXXXXXGXXXXXXXXXXXXXXXXXXXXXGXXXXXXXXXXXXXXXXXXXXXGAXXXXXXXXXXXXXXXXXXXXGAAAAAAAXXXXXXXXXXXXXXGOXXXXXXXXXXXXXXXXXXXXGOXXXXXXXXXXXXXXXXXXXXGXXXXXXXXXXXXXXXXXXXXXGOXXXXXXXXXXXXXXXXXXXXGOXXXXXXXXXXXXXXXXXXXX,0,453,147
17619,29,8,21,179,246,0,0,414,334,80,GOXXXXXXXXXXXXXXXXXXXXGOXXXXXXXXXXXXXXXXXXXXGOXXXXXXXXXXXXXXXXXXXXGOXXXXXXXXXXXXXXXXXXXXGXXXXXXXXXXXXXXXXXXXXXGXXXXXXXXXXXXXXXXXXXXXGAXXXXXXXXXXXXXXXXXXXXGAAAAAAAXXXXXXXXXXXXXXGOXXXXXXXXXXXXXXXXXXXXGOXXXXXXXXXXXXXXXXXXXXGXXXXXXXXXXXXXXXXXXXXXGOXXXXXXXXXXXXXXXXXXXXGOXXXXXXXXXXXXXXXXXXXX,0,453,147

17640,29,7,22,179,246,0,0,416,336,80,GOXXXXXXXXXXXXXXXXXXXXGOXXXXXXXXXXXXXXXXXXXXGOXXXXXXXXXXXXXXXXXXXXGOXXXXXXXXXXXXXXXXXXXXGXXXXXXXXXXXXXXXXXXXXXGXXXXXXXXXXXXXXXXXXXXXGAXXXXXXXXXXXXXXXXXXXXGAOAAAAAXXXXXXXXXXXXXXGOXXXXXXXXXXXXXXXXXXXXGOXXXXXXXXXXXXXXXXXXXXGXXXXXXXXXXXXXXXXXXXXXGOXXXXXXXXXXXXXXXXXXXXGOXXXXXXXXXXXXXXXXXXXX,0,453,147
17661,29,6,23,181,244,0,0,414,334,80,GOXXXXXXXXXXXXXXXXXXXXGOXXXXXXXXXXXXXXXXXXXXGOXXXXXXXXXXXXXXXXXXXXGOXXXXXXXXXXXXXXXXXXXXGXXXXXXXXXXXXXXXXXXXXXGXXXXXXXXXXXXXXXXXXXXXGAXXXXXXXXXXXXXXXXXXXXGAOOAAAAXXXXXXXXXXXXXXGOXXXXXXXXXXXXXXXXXXXXGOXXXXXXXXXXXXXXXXXXXXGXXXXXXXXXXXXXXXXXXXXXGOXXXXXXXXXXXXXXXXXXXXGOXXXXXXXXXXXXXXXXXXXX,0,453,147
17682,29,6,23,181,244,0,0,414,337,77,GOXXXXXXXXXXXXXXXXXXXXGOXXXXXXXXXXXXXXXXXXXXGOXXXXXXXXXXXXXXXXXXXXGOXXXXXXXXXXXXXXXXXXXXGXXXXXXXXXXXXXXXXXXXXXGXXXXXXXXXXXXXXXXXXXXXGAXXXXXXXXXXXXXXXXXXXXGAOOAAAAXXXXXXXXXXXXXXGOXXXXXXXXXXXXXXXXXXXXGOXXXXXXXXXXXXXXXXXXXXGXXXXXXXXXXXXXXXXXXXXXGOXXXXXXXXXXXXXXXXXXXXGOXXXXXXXXXXXXXXXXXXXX,0,453,147
17703,29,6,23,183,242,0,0,412,339,73,GOXXXXXXXXXXXXXXXXXXXXGOXXXXXXXXXXXXXXXXXXXXGOXXXXXXXXXXXXXXXXXXXXGOXXXXXXXXXXXXXXXXXXXXGXXXXXXXXXXXXXXXXXXXXXGXXXXXXXXXXXXXXXXXXXXXGAXXXXXXXXXXXXXXXXXXXXGAOOAAAAXXXXXXXXXXXXXXGOXXXXXXXXXXXXXXXXXXXXGOXXXXXXXXXXXXXXXXXXXXGXXXXXXXXXXXXXXXXXXXXXGOXXXXXXXXXXXXXXXXXXXXGOXXXXXXXXXXXXXXXXXXXX,0,453,147
17724,29,6,23,182,243,0,0,413,346,67,GOXXXXXXXXXXXXXXXXXXXXGOXXXXXXXXXXXXXXXXXXXXGOXXXXXXXXXXXXXXXXXXXXGOXXXXXXXXXXXXXXXXXXXXGXXXXXXXXXXXXXXXXXXXXXGXXXXXXXXXXXXXXXXXXXXXGAXXXXXXXXXXXXXXXXXXXXGAOOAAAAXXXXXXXXXXXXXXGOXXXXXXXXXXXXXXXXXXXXGOXXXXXXXXXXXXXXXXXXXXGXXXXXXXXXXXXXXXXXXXXXGOXXXXXXXXXXXXXXXXXXXXGOXXXXXXXXXXXXXXXXXXXX,0,453,147

17745,29,6,23,187,238,0,0,408,342,66,GOXXXXXXXXXXXXXXXXXXXXGOXXXXXXXXXXXXXXXXXXXXGOXXXXXXXXXXXXXXXXXXXXGOXXXXXXXXXXXXXXXXXXXXGXXXXXXXXXXXXXXXXXXXXXGXXXXXXXXXXXXXXXXXXXXXGAXXXXXXXXXXXXXXXXXXXXGAOOAAAAXXXXXXXXXXXXXXGOXXXXXXXXXXXXXXXXXXXXGOXXXXXXXXXXXXXXXXXXXXGXXXXXXXXXXXXXXXXXXXXXGOXXXXXXXXXXXXXXXXXXXXGOXXXXXXXXXXXXXXXXXXXX,0,453,147
17766,28,6,22,186,239,0,0,409,337,72,GXXXXXXXXXXXXXXXXXXXXXGOXXXXXXXXXXXXXXXXXXXXGOXXXXXXXXXXXXXXXXXXXXGOXXXXXXXXXXXXXXXXXXXXGXXXXXXXXXXXXXXXXXXXXXGXXXXXXXXXXXXXXXXXXXXXGAXXXXXXXXXXXXXXXXXXXXGAOOAAAAXXXXXXXXXXXXXXGOXXXXXXXXXXXXXXXXXXXXGOXXXXXXXXXXXXXXXXXXXXGXXXXXXXXXXXXXXXXXXXXXGOXXXXXXXXXXXXXXXXXXXXGOXXXXXXXXXXXXXXXXXXXX,0,452,148
17787,32,10,22,183,238,0,0,408,338,70,GXXXXXXXXXXXXXXXXXXXXXGOXXXXXXXXXXXXXXXXXXXXGOXXXXXXXXXXXXXXXXXXXXGOXXXXXXXXXXXXXXXXXXXXGXXXXXXXXXXXXXXXXXXXXXGXXXXXXXXXXXXXXXXXXXXXGAXXXXXXXXXXXXXXXXXXXXGAOOAAAAXXXXXXXXXXXXXXGOXXXXXXXXXXXXXXXXXXXXGOAAAAXXXXXXXXXXXXXXXXGXXXXXXXXXXXXXXXXXXXXXGOXXXXXXXXXXXXXXXXXXXXGOXXXXXXXXXXXXXXXXXXXX,0,452,148
17808,32,9,23,184,237,0,0,408,339,69,GXXXXXXXXXXXXXXXXXXXXXGOXXXXXXXXXXXXXXXXXXXXGOXXXXXXXXXXXXXXXXXXXXGOXXXXXXXXXXXXXXXXXXXXGXXXXXXXXXXXXXXXXXXXXXGXXXXXXXXXXXXXXXXXXXXXGAXXXXXXXXXXXXXXXXXXXXGAOOAAAAXXXXXXXXXXXXXXGOXXXXXXXXXXXXXXXXXXXXGOAAOAXXXXXXXXXXXXXXXXGXXXXXXXXXXXXXXXXXXXXXGOXXXXXXXXXXXXXXXXXXXXGOXXXXXXXXXXXXXXXXXXXX,0,452,148
17829,32,8,24,187,234,0,0,406,336,70,GXXXXXXXXXXXXXXXXXXXXXGOXXXXXXXXXXXXXXXXXXXXGOXXXXXXXXXXXXXXXXXXXXGOXXXXXXXXXXXXXXXXXXXXGXXXXXXXXXXXXXXXXXXXXXGXXXXXXXXXXXXXXXXXXXXXGAXXXXXXXXXXXXXXXXXXXXGAOOAAAAXXXXXXXXXXXXXXGOXXXXXXXXXXXXXXXXXXXXGOAAOOXXXXXXXXXXXXXXXXGXXXXXXXXXXXXXXXXXXXXXGOXXXXXXXXXXXXXXXXXXXXGOXXXXXXXXXXXXXXXXXXXX,0,452,148

17850,33,8,25,183,237,0,0,410,333,77,GXXXXXXXXXXXXXXXXXXXXXGOXXXXXXXXXXXXXXXXXXXXGOXXXXXXXXXXXXXXXXXXXXGOXXXXXXXXXXXXXXXXXXXXGXXXXXXXXXXXXXXXXXXXXXGXXXXXXXXXXXXXXXXXXXXXGAXXXXXXXXXXXXXXXXXXXXGAOOAAAOXXXXXXXXXXXXXXGOXXXXXXXXXXXXXXXXXXXXGOAAOOXXXXXXXXXXXXXXXXGXXXXXXXXXXXXXXXXXXXXXGOAXXXXXXXXXXXXXXXXXXXGOXXXXXXXXXXXXXXXXXXXX,0,452,148
17871,33,8,25,185,235,0,0,408,333,75,GXXXXXXXXXXXXXXXXXXXXXGOXXXXXXXXXXXXXXXXXXXXGOXXXXXXXXXXXXXXXXXXXXGOXXXXXXXXXXXXXXXXXXXXGXXXXXXXXXXXXXXXXXXXXXGXXXXXXXXXXXXXXXXXXXXXGAXXXXXXXXXXXXXXXXXXXXGAOOAAAOXXXXXXXXXXXXXXGOXXXXXXXXXXXXXXXXXXXXGOAAOOXXXXXXXXXXXXXXXXGXXXXXXXXXXXXXXXXXXXXXGOAXXXXXXXXXXXXXXXXXXXGOXXXXXXXXXXXXXXXXXXXX,0,452,148
17892,33,7,26,183,237,0,0,410,333,77,GXXXXXXXXXXXXXXXXXXXXXGOXXXXXXXXXXXXXXXXXXXXGOXXXXXXXXXXXXXXXXXXXXGOXXXXXXXXXXXXXXXXXXXXGXXXXXXXXXXXXXXXXXXXXXGXXXXXXXXXXXXXXXXXXXXXGAXXXXXXXXXXXXXXXXXXXXGAOOAAOOXXXXXXXXXXXXXXGOXXXXXXXXXXXXXXXXXXXXGOAAOOXXXXXXXXXXXXXXXXGXXXXXXXXXXXXXXXXXXXXXGOAXXXXXXXXXXXXXXXXXXXGOXXXXXXXXXXXXXXXXXXXX,0,452,148
17913,33,7,26,184,236,0,0,410,340,70,GXXXXXXXXXXXXXXXXXXXXXGOXXXXXXXXXXXXXXXXXXXXGOXXXXXXXXXXXXXXXXXXXXGOXXXXXXXXXXXXXXXXXXXXGXXXXXXXXXXXXXXXXXXXXXGXXXXXXXXXXXXXXXXXXXXXGAXXXXXXXXXXXXXXXXXXXXGAOOAAOOXXXXXXXXXXXXXXGOXXXXXXXXXXXXXXXXXXXXGOAAOOXXXXXXXXXXXXXXXXGXXXXXXXXXXXXXXXXXXXXXGOAXXXXXXXXXXXXXXXXXXXGOXXXXXXXXXXXXXXXXXXXX,0,452,148
17934,33,7,26,186,234,0,0,408,339,69,GXXXXXXXXXXXXXXXXXXXXXGOXXXXXXXXXXXXXXXXXXXXGOXXXXXXXXXXXXXXXXXXXXGOXXXXXXXXXXXXXXXXXXXXGXXXXXXXXXXXXXXXXXXXXXGXXXXXXXXXXXXXXXXXXXXXGAXXXXXXXXXXXXXXXXXXXXGAOOAAOOXXXXXXXXXXXXXXGOXXXXXXXXXXXXXXXXXXXXGOAAOOXXXXXXXXXXXXXXXXGXXXXXXXXXXXXXXXXXXXXXGOAXXXXXXXXXXXXXXXXXXXGOXXXXXXXXXXXXXXXXXXXX,0,452,148

17955,33,7,26,180,240,0,0,414,345,69,GXXXXXXXXXXXXXXXXXXXXXGOXXXXXXXXXXXXXXXXXXXXGOXXXXXXXXXXXXXXXXXXXXGOXXXXXXXXXXXXXXXXXXXXGXXXXXXXXXXXXXXXXXXXXXGXXXXXXXXXXXXXXXXXXXXXGAXXXXXXXXXXXXXXXXXXXXGAOOAAOOXXXXXXXXXXXXXXGOXXXXXXXXXXXXXXXXXXXXGOAAOOXXXXXXXXXXXXXXXXGXXXXXXXXXXXXXXXXXXXXXGOAXXXXXXXXXXXXXXXXXXXGOXXXXXXXXXXXXXXXXXXXX,0,452,148
17976,33,8,25,176,243,0,0,415,344,71,GXXXXXXXXXXXXXXXXXXXXXGOXXXXXXXXXXXXXXXXXXXXGOXXXXXXXXXXXXXXXXXXXXGOXXXXXXXXXXXXXXXXXXXXGAXXXXXXXXXXXXXXXXXXXXGXXXXXXXXXXXXXXXXXXXXXGAXXXXXXXXXXXXXXXXXXXXGAOXAAOOXXXXXXXXXXXXXXGOXXXXXXXXXXXXXXXXXXXXGOAAOOXXXXXXXXXXXXXXXXGXXXXXXXXXXXXXXXXXXXXXGOAXXXXXXXXXXXXXXXXXXXGOXXXXXXXXXXXXXXXXXXXX,0,451,149
17997,34,9,25,175,243,0,0,417,342,75,GXXXXXXXXXXXXXXXXXXXXXGOXXXXXXXXXXXXXXXXXXXXGOXXXXXXXXXXXXXXXXXXXXGOXXXXXXXXXXXXXXXXXXXXGAXXXXXXXXXXXXXXXXXXXXGXXXXXXXXXXXXXXXXXXXXXGAXXXXXXXXXXXXXXXXXXXXGAOXAAOOXXXXXXXXXXXXXXGOXXXXXXXXXXXXXXXXXXXXGOAAOOXXXXXXXXXXXXXXXXGXXXXXXXXXXXXXXXXXXXXXGOAAXXXXXXXXXXXXXXXXXXGOXXXXXXXXXXXXXXXXXXXX,0,451,149
18018,31,8,23,173,248,0,0,420,341,79,GAXXXXXXXXXXXXXXXXXXXXGOXXXXXXXXXXXXXXXXXXXXGOXXXXXXXXXXXXXXXXXXXXGOXXXXXXXXXXXXXXXXXXXXGAXXXXXXXXXXXXXXXXXXXXGXXXXXXXXXXXXXXXXXXXXXGAXXXXXXXXXXXXXXXXXXXXGAOXXXXXXXXXXXXXXXXXXXGOXXXXXXXXXXXXXXXXXXXXGOAAOOXXXXXXXXXXXXXXXXGXXXXXXXXXXXXXXXXXXXXXGOAAXXXXXXXXXXXXXXXXXXGOXXXXXXXXXXXXXXXXXXXX,0,451,149
18039,31,8,23,174,247,0,0,419,339,80,GAXXXXXXXXXXXXXXXXXXXXGOXXXXXXXXXXXXXXXXXXXXGOXXXXXXXXXXXXXXXXXXXXGOXXXXXXXXXXXXXXXXXXXXGAXXXXXXXXXXXXXXXXXXXXGXXXXXXXXXXXXXXXXXXXXXGAXXXXXXXXXXXXXXXXXXXXGAOXXXXXXXXXXXXXXXXXXXGOXXXXXXXXXXXXXXXXXXXXGOAAOOXXXXXXXXXXXXXXXXGXXXXXXXXXXXXXXXXXXXXXGOAAXXXXXXXXXXXXXXXXXXGOXXXXXXXXXXXXXXXXXXXX,0,451,149

18060,31,8,23,178,243,0,0,416,333,83,GAXXXXXXXXXXXXXXXXXXXXGOXXXXXXXXXXXXXXXXXXXXGOXXXXXXXXXXXXXXXXXXXXGOXXXXXXXXXXXXXXXXXXXXGAXXXXXXXXXXXXXXXXXXXXGXXXXXXXXXXXXXXXXXXXXXGAXXXXXXXXXXXXXXXXXXXXGAOXXXXXXXXXXXXXXXXXXXGOXXXXXXXXXXXXXXXXXXXXGOAAOOXXXXXXXXXXXXXXXXGXXXXXXXXXXXXXXXXXXXXXGOAAXXXXXXXXXXXXXXXXXXGOXXXXXXXXXXXXXXXXXXXX,0,451,149
18081,31,7,24,178,243,0,0,417,332,85,GAXXXXXXXXXXXXXXXXXXXXGOXXXXXXXXXXXXXXXXXXXXGOXXXXXXXXXXXXXXXXXXXXGOXXXXXXXXXXXXXXXXXXXXGAXXXXXXXXXXXXXXXXXXXXGXXXXXXXXXXXXXXXXXXXXXGOXXXXXXXXXXXXXXXXXXXXGAOXXXXXXXXXXXXXXXXXXXGOXXXXXXXXXXXXXXXXXXXXGOAAOOXXXXXXXXXXXXXXXXGXXXXXXXXXXXXXXXXXXXXXGOAAXXXXXXXXXXXXXXXXXXGOXXXXXXXXXXXXXXXXXXXX,0,451,149
18102,32,7,25,177,243,0,0,418,332,86,GAXXXXXXXXXXXXXXXXXXXXGOXXXXXXXXXXXXXXXXXXXXGOXXXXXXXXXXXXXXXXXXXXGOXXXXXXXXXXXXXXXXXXXXGAXXXXXXXXXXXXXXXXXXXXGXXXXXXXXXXXXXXXXXXXXXGOXXXXXXXXXXXXXXXXXXXXGAOXXXXXXXXXXXXXXXXXXXGOXXXXXXXXXXXXXXXXXXXXGOAOOOXXXXXXXXXXXXXXXXGXXXXXXXXXXXXXXXXXXXXXGOAAXXXXXXXXXXXXXXXXXXGOAXXXXXXXXXXXXXXXXXXX,0,451,149
18123,31,7,24,177,243,0,0,417,332,85,GAXXXXXXXXXXXXXXXXXXXXGOXXXXXXXXXXXXXXXXXXXXGOXXXXXXXXXXXXXXXXXXXXGOXXXXXXXXXXXXXXXXXXXXGAXXXXXXXXXXXXXXXXXXXXGXXXXXXXXXXXXXXXXXXXXXGOXXXXXXXXXXXXXXXXXXXXGAOXXXXXXXXXXXXXXXXXXXGXXXXXXXXXXXXXXXXXXXXXGOAOOOXXXXXXXXXXXXXXXXGXXXXXXXXXXXXXXXXXXXXXGOAAXXXXXXXXXXXXXXXXXXGOAXXXXXXXXXXXXXXXXXXX,0,450,150
18144,32,8,24,184,235,0,0,409,320,89,GAXXXXXXXXXXXXXXXXXXXXGOXXXXXXXXXXXXXXXXXXXXGOXXXXXXXXXXXXXXXXXXXXGOXXXXXXXXXXXXXXXXXXXXGAXXXXXXXXXXXXXXXXXXXXGXXXXXXXXXXXXXXXXXXXXXGOXXXXXXXXXXXXXXXXXXXXGAOXXXXXXXXXXXXXXXXXXXGXXXXXXXXXXXXXXXXXXXXXGOAOOOAXXXXXXXXXXXXXXXGXXXXXXXXXXXXXXXXXXXXXGOAAXXXXXXXXXXXXXXXXXXGOAXXXXXXXXXXXXXXXXXXX,0,450,150

18165,32,8,24,186,233,0,0,408,317,91,GAXXXXXXXXXXXXXXXXXXXXGOXXXXXXXXXXXXXXXXXXXXGOXXXXXXXXXXXXXXXXXXXXGOXXXXXXXXXXXXXXXXXXXXGAXXXXXXXXXXXXXXXXXXXXGXXXXXXXXXXXXXXXXXXXXXGOXXXXXXXXXXXXXXXXXXXXGAOXXXXXXXXXXXXXXXXXXXGXXXXXXXXXXXXXXXXXXXXXGOAOOOAXXXXXXXXXXXXXXXGXXXXXXXXXXXXXXXXXXXXXGOAAXXXXXXXXXXXXXXXXXXGOAXXXXXXXXXXXXXXXXXXX,0,450,150
18186,32,8,24,181,238,0,0,412,314,98,GAXXXXXXXXXXXXXXXXXXXXGOXXXXXXXXXXXXXXXXXXXXGOXXXXXXXXXXXXXXXXXXXXGOXXXXXXXXXXXXXXXXXXXXGAXXXXXXXXXXXXXXXXXXXXGXXXXXXXXXXXXXXXXXXXXXGOXXXXXXXXXXXXXXXXXXXXGAOXXXXXXXXXXXXXXXXXXXGXXXXXXXXXXXXXXXXXXXXXGOAOOOAXXXXXXXXXXXXXXXGXXXXXXXXXXXXXXXXXXXXXGOAAXXXXXXXXXXXXXXXXXXGOAXXXXXXXXXXXXXXXXXXX,0,450,150
18207,33,10,23,176,241,0,0,415,314,101,GAXXXXXXXXXXXXXXXXXXXXGOXXXXXXXXXXXXXXXXXXXXGOXXXXXXXXXXXXXXXXXXXXGOAXXXXXXXXXXXXXXXXXXXGAXXXXXXXXXXXXXXXXXXXXGAXXXXXXXXXXXXXXXXXXXXGOXXXXXXXXXXXXXXXXXXXXGAOXXXXXXXXXXXXXXXXXXXGXXXXXXXXXXXXXXXXXXXXXGOAXOOAXXXXXXXXXXXXXXXGXXXXXXXXXXXXXXXXXXXXXGOAAXXXXXXXXXXXXXXXXXXGOAXXXXXXXXXXXXXXXXXXX,0,449,151
18228,33,10,23,178,239,0,0,412,312,100,GAXXXXXXXXXXXXXXXXXXXXGOXXXXXXXXXXXXXXXXXXXXGOXXXXXXXXXXXXXXXXXXXXGOAXXXXXXXXXXXXXXXXXXXGAXXXXXXXXXXXXXXXXXXXXGAXXXXXXXXXXXXXXXXXXXXGOXXXXXXXXXXXXXXXXXXXXGAOXXXXXXXXXXXXXXXXXXXGXXXXXXXXXXXXXXXXXXXXXGOAXOOAXXXXXXXXXXXXXXXGXXXXXXXXXXXXXXXXXXXXXGOAAXXXXXXXXXXXXXXXXXXGOAXXXXXXXXXXXXXXXXXXX,0,449,151
18249,31,10,21,181,238,0,0,410,314,96,GAXXXXXXXXXXXXXXXXXXXXGOXXXXXXXXXXXXXXXXXXXXGOXXXXXXXXXXXXXXXXXXXXGOAXXXXXXXXXXXXXXXXXXXGAXXXXXXXXXXXXXXXXXXXXGAXXXXXXXXXXXXXXXXXXXXGOXXXXXXXXXXXXXXXXXXXXGAOXXXXXXXXXXXXXXXXXXXGXXXXXXXXXXXXXXXXXXXXXGOAXXXXXXXXXXXXXXXXXXXGXXXXXXXXXXXXXXXXXXXXXGOAAXXXXXXXXXXXXXXXXXXGOAAXXXXXXXXXXXXXXXXXX,0,449,151

18270,31,10,21,177,242,0,0,413,317,96,GAXXXXXXXXXXXXXXXXXXXXGOXXXXXXXXXXXXXXXXXXXXGOXXXXXXXXXXXXXXXXXXXXGOAXXXXXXXXXXXXXXXXXXXGAXXXXXXXXXXXXXXXXXXXXGAXXXXXXXXXXXXXXXXXXXXGOXXXXXXXXXXXXXXXXXXXXGAOXXXXXXXXXXXXXXXXXXXGXXXXXXXXXXXXXXXXXXXXXGOAXXXXXXXXXXXXXXXXXXXGXXXXXXXXXXXXXXXXXXXXXGOAAXXXXXXXXXXXXXXXXXXGOAAXXXXXXXXXXXXXXXXXX,0,449,151
18291,31,10,21,175,244,0,0,416,321,95,GAXXXXXXXXXXXXXXXXXXXXGOXXXXXXXXXXXXXXXXXXXXGOXXXXXXXXXXXXXXXXXXXXGOAXXXXXXXXXXXXXXXXXXXGAXXXXXXXXXXXXXXXXXXXXGAXXXXXXXXXXXXXXXXXXXXGOXXXXXXXXXXXXXXXXXXXXGAOXXXXXXXXXXXXXXXXXXXGXXXXXXXXXXXXXXXXXXXXXGOAXXXXXXXXXXXXXXXXXXXGXXXXXXXXXXXXXXXXXXXXXGOAAXXXXXXXXXXXXXXXXXXGOAAXXXXXXXXXXXXXXXXXX,0,449,151
18312,31,10,21,175,244,0,0,415,320,95,GAXXXXXXXXXXXXXXXXXXXXGOXXXXXXXXXXXXXXXXXXXXGOXXXXXXXXXXXXXXXXXXXXGOAXXXXXXXXXXXXXXXXXXXGAXXXXXXXXXXXXXXXXXXXXGAXXXXXXXXXXXXXXXXXXXXGOXXXXXXXXXXXXXXXXXXXXGAOXXXXXXXXXXXXXXXXXXXGXXXXXXXXXXXXXXXXXXXXXGOAXXXXXXXXXXXXXXXXXXXGXXXXXXXXXXXXXXXXXXXXXGOAAXXXXXXXXXXXXXXXXXXGOAAXXXXXXXXXXXXXXXXXX,0,449,151
18333,31,9,22,172,247,0,0,420,324,96,GAXXXXXXXXXXXXXXXXXXXXGOXXXXXXXXXXXXXXXXXXXXGOXXXXXXXXXXXXXXXXXXXXGOAXXXXXXXXXXXXXXXXXXXGAXXXXXXXXXXXXXXXXXXXXGAXXXXXXXXXXXXXXXXXXXXGOXXXXXXXXXXXXXXXXXXXXGAOXXXXXXXXXXXXXXXXXXXGXXXXXXXXXXXXXXXXXXXXXGOOXXXXXXXXXXXXXXXXXXXGXXXXXXXXXXXXXXXXXXXXXGOAAXXXXXXXXXXXXXXXXXXGOAAXXXXXXXXXXXXXXXXXX,0,449,151
18354,31,9,22,174,245,0,0,418,323,95,GAXXXXXXXXXXXXXXXXXXXXGOXXXXXXXXXXXXXXXXXXXXGOXXXXXXXXXXXXXXXXXXXXGOAXXXXXXXXXXXXXXXXXXXGAXXXXXXXXXXXXXXXXXXXXGAXXXXXXXXXXXXXXXXXXXXGOXXXXXXXXXXXXXXXXXXXXGAOXXXXXXXXXXXXXXXXXXXGXXXXXXXXXXXXXXXXXXXXXGOOXXXXXXXXXXXXXXXXXXXGXXXXXXXXXXXXXXXXXXXXXGOAAXXXXXXXXXXXXXXXXXXGOAAXXXXXXXXXXXXXXXXXX,0,449,151

18375,31,9,22,173,246,0,0,419,327,92,GAXXXXXXXXXXXXXXXXXXXXGOXXXXXXXXXXXXXXXXXXXXGOXXXXXXXXXXXXXXXXXXXXGOAXXXXXXXXXXXXXXXXXXXGAXXXXXXXXXXXXXXXXXXXXGAXXXXXXXXXXXXXXXXXXXXGOXXXXXXXXXXXXXXXXXXXXGAOXXXXXXXXXXXXXXXXXXXGXXXXXXXXXXXXXXXXXXXXXGOOXXXXXXXXXXXXXXXXXXXGXXXXXXXXXXXXXXXXXXXXXGOAAXXXXXXXXXXXXXXXXXXGOAAXXXXXXXXXXXXXXXXXX,0,449,151
18396,31,9,22,170,249,0,0,422,328,94,GAXXXXXXXXXXXXXXXXXXXXGOXXXXXXXXXXXXXXXXXXXXGOXXXXXXXXXXXXXXXXXXXXGOAXXXXXXXXXXXXXXXXXXXGAXXXXXXXXXXXXXXXXXXXXGAXXXXXXXXXXXXXXXXXXXXGOXXXXXXXXXXXXXXXXXXXXGAOXXXXXXXXXXXXXXXXXXXGXXXXXXXXXXXXXXXXXXXXXGOOXXXXXXXXXXXXXXXXXXXGXXXXXXXXXXXXXXXXXXXXXGOAAXXXXXXXXXXXXXXXXXXGOAAXXXXXXXXXXXXXXXXXX,0,449,151
18417,32,10,22,170,248,0,0,421,329,92,GAXXXXXXXXXXXXXXXXXXXXGOXXXXXXXXXXXXXXXXXXXXGOXXXXXXXXXXXXXXXXXXXXGOAAXXXXXXXXXXXXXXXXXXGAXXXXXXXXXXXXXXXXXXXXGAXXXXXXXXXXXXXXXXXXXXGOXXXXXXXXXXXXXXXXXXXXGAOXXXXXXXXXXXXXXXXXXXGXXXXXXXXXXXXXXXXXXXXXGOOXXXXXXXXXXXXXXXXXXXGXXXXXXXXXXXXXXXXXXXXXGOAAXXXXXXXXXXXXXXXXXXGOAAXXXXXXXXXXXXXXXXXX,0,449,151
18438,32,10,22,172,246,0,0,419,331,88,GAXXXXXXXXXXXXXXXXXXXXGOXXXXXXXXXXXXXXXXXXXXGOXXXXXXXXXXXXXXXXXXXXGOAAXXXXXXXXXXXXXXXXXXGAXXXXXXXXXXXXXXXXXXXXGAXXXXXXXXXXXXXXXXXXXXGOXXXXXXXXXXXXXXXXXXXXGAOXXXXXXXXXXXXXXXXXXXGXXXXXXXXXXXXXXXXXXXXXGOOXXXXXXXXXXXXXXXXXXXGXXXXXXXXXXXXXXXXXXXXXGOAAXXXXXXXXXXXXXXXXXXGOAAXXXXXXXXXXXXXXXXXX,0,449,151
18459,32,10,22,175,242,0,0,416,331,85,GXXXXXXXXXXXXXXXXXXXXXGOXXXXXXXXXXXXXXXXXXXXGOXXXXXXXXXXXXXXXXXXXXGOAAXXXXXXXXXXXXXXXXXXGAXXXXXXXXXXXXXXXXXXXXGAXXXXXXXXXXXXXXXXXXXXGOXXXXXXXXXXXXXXXXXXXXGAOXXXXXXXXXXXXXXXXXXXGXXXXXXXXXXXXXXXXXXXXXGOOXXXXXXXXXXXXXXXXXXXGAXXXXXXXXXXXXXXXXXXXXGOAAXXXXXXXXXXXXXXXXXXGOAAXXXXXXXXXXXXXXXXXX,0,448,152

18480,33,10,23,171,245,0,0,420,332,88,GXXXXXXXXXXXXXXXXXXXXXGOXXXXXXXXXXXXXXXXXXXXGOXXXXXXXXXXXXXXXXXXXXGOOAXXXXXXXXXXXXXXXXXXGAXXXXXXXXXXXXXXXXXXXXGAXXXXXXXXXXXXXXXXXXXXGOXXXXXXXXXXXXXXXXXXXXGAOXXXXXXXXXXXXXXXXXXXGXXXXXXXXXXXXXXXXXXXXXGOOXXXXXXXXXXXXXXXXXXXGAXXXXXXXXXXXXXXXXXXXXGOAAXXXXXXXXXXXXXXXXXXGOAAAXXXXXXXXXXXXXXXXX,0,448,152
18501,33,10,23,173,243,0,0,418,330,88,GXXXXXXXXXXXXXXXXXXXXXGOXXXXXXXXXXXXXXXXXXXXGOXXXXXXXXXXXXXXXXXXXXGOOAXXXXXXXXXXXXXXXXXXGAXXXXXXXXXXXXXXXXXXXXGAXXXXXXXXXXXXXXXXXXXXGOXXXXXXXXXXXXXXXXXXXXGAOXXXXXXXXXXXXXXXXXXXGXXXXXXXXXXXXXXXXXXXXXGOOXXXXXXXXXXXXXXXXXXXGAXXXXXXXXXXXXXXXXXXXXGOAAXXXXXXXXXXXXXXXXXXGOAAAXXXXXXXXXXXXXXXXX,0,448,152
18522,33,9,24,179,237,0,0,414,324,90,GXXXXXXXXXXXXXXXXXXXXXGOXXXXXXXXXXXXXXXXXXXXGOXXXXXXXXXXXXXXXXXXXXGOOAXXXXXXXXXXXXXXXXXXGAXXXXXXXXXXXXXXXXXXXXGAXXXXXXXXXXXXXXXXXXXXGOXXXXXXXXXXXXXXXXXXXXGAOXXXXXXXXXXXXXXXXXXXGXXXXXXXXXXXXXXXXXXXXXGOOXXXXXXXXXXXXXXXXXXXGAXXXXXXXXXXXXXXXXXXXXGOAAXXXXXXXXXXXXXXXXXXGOAOAXXXXXXXXXXXXXXXXX,0,448,152
18543,32,9,23,179,237,0,0,414,328,86,GXXXXXXXXXXXXXXXXXXXXXGOXXXXXXXXXXXXXXXXXXXXGOXXXXXXXXXXXXXXXXXXXXGOOAXXXXXXXXXXXXXXXXXXGAXXXXXXXXXXXXXXXXXXXXGAXXXXXXXXXXXXXXXXXXXXGXXXXXXXXXXXXXXXXXXXXXGAOXXXXXXXXXXXXXXXXXXXGXXXXXXXXXXXXXXXXXXXXXGOOXXXXXXXXXXXXXXXXXXXGAXXXXXXXXXXXXXXXXXXXXGOAAXXXXXXXXXXXXXXXXXXGOAOAXXXXXXXXXXXXXXXXX,0,447,153
18564,32,9,23,181,235,0,0,412,327,85,GXXXXXXXXXXXXXXXXXXXXXGOXXXXXXXXXXXXXXXXXXXXGOXXXXXXXXXXXXXXXXXXXXGOOAXXXXXXXXXXXXXXXXXXGAXXXXXXXXXXXXXXXXXXXXGAXXXXXXXXXXXXXXXXXXXXGXXXXXXXXXXXXXXXXXXXXXGAOXXXXXXXXXXXXXXXXXXXGXXXXXXXXXXXXXXXXXXXXXGOOXXXXXXXXXXXXXXXXXXXGAXXXXXXXXXXXXXXXXXXXXGOAAXXXXXXXXXXXXXXXXXXGOAOAXXXXXXXXXXXXXXXXX,0,447,153

18585,32,9,23,184,232,0,0,408,332,76,GXXXXXXXXXXXXXXXXXXXXXGOXXXXXXXXXXXXXXXXXXXXGOXXXXXXXXXXXXXXXXXXXXGOOAXXXXXXXXXXXXXXXXXXGAXXXXXXXXXXXXXXXXXXXXGAXXXXXXXXXXXXXXXXXXXXGXXXXXXXXXXXXXXXXXXXXXGAOXXXXXXXXXXXXXXXXXXXGXXXXXXXXXXXXXXXXXXXXXGOOXXXXXXXXXXXXXXXXXXXGAXXXXXXXXXXXXXXXXXXXXGOAAXXXXXXXXXXXXXXXXXXGOAOAXXXXXXXXXXXXXXXXX,0,447,153
18606,33,10,23,182,233,0,0,410,336,74,GXXXXXXXXXXXXXXXXXXXXXGOXXXXXXXXXXXXXXXXXXXXGOXXXXXXXXXXXXXXXXXXXXGOOAXXXXXXXXXXXXXXXXXXGAXXXXXXXXXXXXXXXXXXXXGAXXXXXXXXXXXXXXXXXXXXGXXXXXXXXXXXXXXXXXXXXXGAOAXXXXXXXXXXXXXXXXXXGXXXXXXXXXXXXXXXXXXXXXGOOXXXXXXXXXXXXXXXXXXXGAXXXXXXXXXXXXXXXXXXXXGOAAXXXXXXXXXXXXXXXXXXGOAOAXXXXXXXXXXXXXXXXX,0,447,153
18627,33,9,24,186,229,0,0,407,336,71,GXXXXXXXXXXXXXXXXXXXXXGOXXXXXXXXXXXXXXXXXXXXGOXXXXXXXXXXXXXXXXXXXXGOOAXXXXXXXXXXXXXXXXXXGAXXXXXXXXXXXXXXXXXXXXGAXXXXXXXXXXXXXXXXXXXXGXXXXXXXXXXXXXXXXXXXXXGAOAXXXXXXXXXXXXXXXXXXGXXXXXXXXXXXXXXXXXXXXXGOOXXXXXXXXXXXXXXXXXXXGOXXXXXXXXXXXXXXXXXXXXGOAAXXXXXXXXXXXXXXXXXXGOAOAXXXXXXXXXXXXXXXXX,0,447,153
18648,33,9,24,181,234,0,0,412,341,71,GXXXXXXXXXXXXXXXXXXXXXGOXXXXXXXXXXXXXXXXXXXXGOXXXXXXXXXXXXXXXXXXXXGOOAXXXXXXXXXXXXXXXXXXGAXXXXXXXXXXXXXXXXXXXXGAXXXXXXXXXXXXXXXXXXXXGXXXXXXXXXXXXXXXXXXXXXGAOAXXXXXXXXXXXXXXXXXXGXXXXXXXXXXXXXXXXXXXXXGOOXXXXXXXXXXXXXXXXXXXGOXXXXXXXXXXXXXXXXXXXXGOAAXXXXXXXXXXXXXXXXXXGOAOAXXXXXXXXXXXXXXXXX,0,447,153
18669,33,8,25,184,231,0,0,410,339,71,GXXXXXXXXXXXXXXXXXXXXXGOXXXXXXXXXXXXXXXXXXXXGOXXXXXXXXXXXXXXXXXXXXGOOAXXXXXXXXXXXXXXXXXXGOXXXXXXXXXXXXXXXXXXXXGAXXXXXXXXXXXXXXXXXXXXGXXXXXXXXXXXXXXXXXXXXXGAOAXXXXXXXXXXXXXXXXXXGXXXXXXXXXXXXXXXXXXXXXGOOXXXXXXXXXXXXXXXXXXXGOXXXXXXXXXXXXXXXXXXXXGOAAXXXXXXXXXXXXXXXXXXGOAOAXXXXXXXXXXXXXXXXX,0,447,153

18690,33,8,25,182,233,0,0,412,338,74,GXXXXXXXXXXXXXXXXXXXXXGOXXXXXXXXXXXXXXXXXXXXGOXXXXXXXXXXXXXXXXXXXXGOOAXXXXXXXXXXXXXXXXXXGOXXXXXXXXXXXXXXXXXXXXGAXXXXXXXXXXXXXXXXXXXXGXXXXXXXXXXXXXXXXXXXXXGAOAXXXXXXXXXXXXXXXXXXGXXXXXXXXXXXXXXXXXXXXXGOOXXXXXXXXXXXXXXXXXXXGOXXXXXXXXXXXXXXXXXXXXGOAAXXXXXXXXXXXXXXXXXXGOAOAXXXXXXXXXXXXXXXXX,0,447,153
18711,33,7,26,186,229,0,0,409,336,73,GXXXXXXXXXXXXXXXXXXXXXGOXXXXXXXXXXXXXXXXXXXXGOXXXXXXXXXXXXXXXXXXXXGOOAXXXXXXXXXXXXXXXXXXGOXXXXXXXXXXXXXXXXXXXXGAXXXXXXXXXXXXXXXXXXXXGXXXXXXXXXXXXXXXXXXXXXGAOAXXXXXXXXXXXXXXXXXXGXXXXXXXXXXXXXXXXXXXXXGOOXXXXXXXXXXXXXXXXXXXGOXXXXXXXXXXXXXXXXXXXXGOAAXXXXXXXXXXXXXXXXXXGOOOAXXXXXXXXXXXXXXXXX,0,447,153
18732,33,6,27,186,229,0,0,410,338,72,GXXXXXXXXXXXXXXXXXXXXXGOXXXXXXXXXXXXXXXXXXXXGOXXXXXXXXXXXXXXXXXXXXGOOAXXXXXXXXXXXXXXXXXXGOXXXXXXXXXXXXXXXXXXXXGAXXXXXXXXXXXXXXXXXXXXGXXXXXXXXXXXXXXXXXXXXXGAOAXXXXXXXXXXXXXXXXXXGXXXXXXXXXXXXXXXXXXXXXGOOXXXXXXXXXXXXXXXXXXXGOXXXXXXXXXXXXXXXXXXXXGOOAXXXXXXXXXXXXXXXXXXGOOOAXXXXXXXXXXXXXXXXX,0,447,153
18753,33,6,27,188,227,0,0,408,336,72,GXXXXXXXXXXXXXXXXXXXXXGOXXXXXXXXXXXXXXXXXXXXGOXXXXXXXXXXXXXXXXXXXXGOOAXXXXXXXXXXXXXXXXXXGOXXXXXXXXXXXXXXXXXXXXGAXXXXXXXXXXXXXXXXXXXXGXXXXXXXXXXXXXXXXXXXXXGAOAXXXXXXXXXXXXXXXXXXGXXXXXXXXXXXXXXXXXXXXXGOOXXXXXXXXXXXXXXXXXXXGOXXXXXXXXXXXXXXXXXXXXGOOAXXXXXXXXXXXXXXXXXXGOOOAXXXXXXXXXXXXXXXXX,0,447,153
18774,33,6,27,189,226,0,0,407,338,69,GXXXXXXXXXXXXXXXXXXXXXGOXXXXXXXXXXXXXXXXXXXXGOXXXXXXXXXXXXXXXXXXXXGOOAXXXXXXXXXXXXXXXXXXGOXXXXXXXXXXXXXXXXXXXXGAXXXXXXXXXXXXXXXXXXXXGXXXXXXXXXXXXXXXXXXXXXGAOAXXXXXXXXXXXXXXXXXXGXXXXXXXXXXXXXXXXXXXXXGOOXXXXXXXXXXXXXXXXXXXGOXXXXXXXXXXXXXXXXXXXXGOOAXXXXXXXXXXXXXXXXXXGOOOAXXXXXXXXXXXXXXXXX,0,447,153

18795,33,6,27,194,221,0,0,402,331,71,GXXXXXXXXXXXXXXXXXXXXXGOXXXXXXXXXXXXXXXXXXXXGOXXXXXXXXXXXXXXXXXXXXGOOAXXXXXXXXXXXXXXXXXXGOXXXXXXXXXXXXXXXXXXXXGAXXXXXXXXXXXXXXXXXXXXGXXXXXXXXXXXXXXXXXXXXXGAOAXXXXXXXXXXXXXXXXXXGXXXXXXXXXXXXXXXXXXXXXGOOXXXXXXXXXXXXXXXXXXXGOXXXXXXXXXXXXXXXXXXXXGOOAXXXXXXXXXXXXXXXXXXGOOOAXXXXXXXXXXXXXXXXX,0,447,153
18816,32,6,26,195,220,0,0,401,329,72,GXXXXXXXXXXXXXXXXXXXXXGOXXXXXXXXXXXXXXXXXXXXGOXXXXXXXXXXXXXXXXXXXXGOOAXXXXXXXXXXXXXXXXXXGOXXXXXXXXXXXXXXXXXXXXGAXXXXXXXXXXXXXXXXXXXXGXXXXXXXXXXXXXXXXXXXXXGAOAXXXXXXXXXXXXXXXXXXGXXXXXXXXXXXXXXXXXXXXXGOOXXXXXXXXXXXXXXXXXXXGOXXXXXXXXXXXXXXXXXXXXGOOAXXXXXXXXXXXXXXXXXXGOOXAXXXXXXXXXXXXXXXXX,0,446,154
18837,32,6,26,197,218,0,0,399,334,65,GXXXXXXXXXXXXXXXXXXXXXGOXXXXXXXXXXXXXXXXXXXXGOXXXXXXXXXXXXXXXXXXXXGOOAXXXXXXXXXXXXXXXXXXGOXXXXXXXXXXXXXXXXXXXXGAXXXXXXXXXXXXXXXXXXXXGXXXXXXXXXXXXXXXXXXXXXGAOAXXXXXXXXXXXXXXXXXXGXXXXXXXXXXXXXXXXXXXXXGOOXXXXXXXXXXXXXXXXXXXGOXXXXXXXXXXXXXXXXXXXXGOOAXXXXXXXXXXXXXXXXXXGOOXAXXXXXXXXXXXXXXXXX,0,446,154
18858,31,5,26,199,217,0,0,398,333,65,GXXXXXXXXXXXXXXXXXXXXXGOXXXXXXXXXXXXXXXXXXXXGOXXXXXXXXXXXXXXXXXXXXGOOAXXXXXXXXXXXXXXXXXXGOXXXXXXXXXXXXXXXXXXXXGAXXXXXXXXXXXXXXXXXXXXGXXXXXXXXXXXXXXXXXXXXXGAOAXXXXXXXXXXXXXXXXXXGXXXXXXXXXXXXXXXXXXXXXGOOXXXXXXXXXXXXXXXXXXXGOXXXXXXXXXXXXXXXXXXXXGOOAXXXXXXXXXXXXXXXXXXGOOXXXXXXXXXXXXXXXXXXX,0,446,154
18879,31,5,26,197,219,0,0,400,330,70,GXXXXXXXXXXXXXXXXXXXXXGOXXXXXXXXXXXXXXXXXXXXGOXXXXXXXXXXXXXXXXXXXXGOOAXXXXXXXXXXXXXXXXXXGOXXXXXXXXXXXXXXXXXXXXGAXXXXXXXXXXXXXXXXXXXXGXXXXXXXXXXXXXXXXXXXXXGAOAXXXXXXXXXXXXXXXXXXGXXXXXXXXXXXXXXXXXXXXXGOOXXXXXXXXXXXXXXXXXXXGOXXXXXXXXXXXXXXXXXXXXGOOAXXXXXXXXXXXXXXXXXXGOOXXXXXXXXXXXXXXXXXXX,0,446,154

18900,31,6,25,199,216,0,0,397,325,72,GXXXXXXXXXXXXXXXXXXXXXGOXXXXXXXXXXXXXXXXXXXXGXXXXXXXXXXXXXXXXXXXXXGOOAAXXXXXXXXXXXXXXXXXGOXXXXXXXXXXXXXXXXXXXXGAXXXXXXXXXXXXXXXXXXXXGXXXXXXXXXXXXXXXXXXXXXGAOAXXXXXXXXXXXXXXXXXXGXXXXXXXXXXXXXXXXXXXXXGOOXXXXXXXXXXXXXXXXXXXGOXXXXXXXXXXXXXXXXXXXXGOOAXXXXXXXXXXXXXXXXXXGOOXXXXXXXXXXXXXXXXXXX,0,445,155
18921,32,7,25,200,214,0,0,395,318,77,GXXXXXXXXXXXXXXXXXXXXXGOXXXXXXXXXXXXXXXXXXXXGXXXXXXXXXXXXXXXXXXXXXGOOAAXXXXXXXXXXXXXXXXXGOXXXXXXXXXXXXXXXXXXXXGAXXXXXXXXXXXXXXXXXXXXGXXXXXXXXXXXXXXXXXXXXXGAOAXXXXXXXXXXXXXXXXXXGAXXXXXXXXXXXXXXXXXXXXGOOXXXXXXXXXXXXXXXXXXXGOXXXXXXXXXXXXXXXXXXXXGOOAXXXXXXXXXXXXXXXXXXGOOXXXXXXXXXXXXXXXXXXX,0,445,155
18942,31,6,25,200,214,0,0,396,313,83,GXXXXXXXXXXXXXXXXXXXXXGOXXXXXXXXXXXXXXXXXXXXGXXXXXXXXXXXXXXXXXXXXXGOOAAXXXXXXXXXXXXXXXXXGXXXXXXXXXXXXXXXXXXXXXGAXXXXXXXXXXXXXXXXXXXXGXXXXXXXXXXXXXXXXXXXXXGAOAXXXXXXXXXXXXXXXXXXGAXXXXXXXXXXXXXXXXXXXXGOOXXXXXXXXXXXXXXXXXXXGOXXXXXXXXXXXXXXXXXXXXGOOOXXXXXXXXXXXXXXXXXXGOOXXXXXXXXXXXXXXXXXXX,0,444,156
18963,31,5,26,200,214,0,0,397,311,86,GXXXXXXXXXXXXXXXXXXXXXGOXXXXXXXXXXXXXXXXXXXXGXXXXXXXXXXXXXXXXXXXXXGOOAAXXXXXXXXXXXXXXXXXGXXXXXXXXXXXXXXXXXXXXXGAXXXXXXXXXXXXXXXXXXXXGXXXXXXXXXXXXXXXXXXXXXGOOAXXXXXXXXXXXXXXXXXXGAXXXXXXXXXXXXXXXXXXXXGOOXXXXXXXXXXXXXXXXXXXGOXXXXXXXXXXXXXXXXXXXXGOOOXXXXXXXXXXXXXXXXXXGOOXXXXXXXXXXXXXXXXXXX,0,444,156
18984,31,5,26,198,216,0,0,399,317,82,GXXXXXXXXXXXXXXXXXXXXXGOXXXXXXXXXXXXXXXXXXXXGXXXXXXXXXXXXXXXXXXXXXGOOAAXXXXXXXXXXXXXXXXXGXXXXXXXXXXXXXXXXXXXXXGAXXXXXXXXXXXXXXXXXXXXGXXXXXXXXXXXXXXXXXXXXXGOOAXXXXXXXXXXXXXXXXXXGAXXXXXXXXXXXXXXXXXXXXGOOXXXXXXXXXXXXXXXXXXXGOXXXXXXXXXXXXXXXXXXXXGOOOXXXXXXXXXXXXXXXXXXGOOXXXXXXXXXXXXXXXXXXX,0,444,156

19005,31,5,26,201,213,0,0,396,315,81,GXXXXXXXXXXXXXXXXXXXXXGOXXXXXXXXXXXXXXXXXXXXGXXXXXXXXXXXXXXXXXXXXXGOOAAXXXXXXXXXXXXXXXXXGXXXXXXXXXXXXXXXXXXXXXGAXXXXXXXXXXXXXXXXXXXXGXXXXXXXXXXXXXXXXXXXXXGOOAXXXXXXXXXXXXXXXXXXGAXXXXXXXXXXXXXXXXXXXXGOOXXXXXXXXXXXXXXXXXXXGOXXXXXXXXXXXXXXXXXXXXGOOOXXXXXXXXXXXXXXXXXXGOOXXXXXXXXXXXXXXXXXXX,0,444,156
19026,32,6,26,197,216,0,0,399,318,81,GXXXXXXXXXXXXXXXXXXXXXGOAXXXXXXXXXXXXXXXXXXXGXXXXXXXXXXXXXXXXXXXXXGOOAAXXXXXXXXXXXXXXXXXGXXXXXXXXXXXXXXXXXXXXXGAXXXXXXXXXXXXXXXXXXXXGXXXXXXXXXXXXXXXXXXXXXGOOAXXXXXXXXXXXXXXXXXXGAXXXXXXXXXXXXXXXXXXXXGOOXXXXXXXXXXXXXXXXXXXGOXXXXXXXXXXXXXXXXXXXXGOOOXXXXXXXXXXXXXXXXXXGOOXXXXXXXXXXXXXXXXXXX,0,444,156
19047,32,6,26,203,210,0,0,394,312,82,GXXXXXXXXXXXXXXXXXXXXXGOAXXXXXXXXXXXXXXXXXXXGXXXXXXXXXXXXXXXXXXXXXGOOAAXXXXXXXXXXXXXXXXXGXXXXXXXXXXXXXXXXXXXXXGAXXXXXXXXXXXXXXXXXXXXGXXXXXXXXXXXXXXXXXXXXXGOOAXXXXXXXXXXXXXXXXXXGAXXXXXXXXXXXXXXXXXXXXGOOXXXXXXXXXXXXXXXXXXXGOXXXXXXXXXXXXXXXXXXXXGOOOXXXXXXXXXXXXXXXXXXGOOXXXXXXXXXXXXXXXXXXX,0,444,156
19068,32,6,26,206,207,0,0,392,309,83,GXXXXXXXXXXXXXXXXXXXXXGOAXXXXXXXXXXXXXXXXXXXGXXXXXXXXXXXXXXXXXXXXXGOOAAXXXXXXXXXXXXXXXXXGXXXXXXXXXXXXXXXXXXXXXGAXXXXXXXXXXXXXXXXXXXXGXXXXXXXXXXXXXXXXXXXXXGOOAXXXXXXXXXXXXXXXXXXGAXXXXXXXXXXXXXXXXXXXXGOOXXXXXXXXXXXXXXXXXXXGOXXXXXXXXXXXXXXXXXXXXGOOOXXXXXXXXXXXXXXXXXXGOOXXXXXXXXXXXXXXXXXXX,0,444,156
19089,32,6,26,200,213,0,0,397,308,89,GXXXXXXXXXXXXXXXXXXXXXGOAXXXXXXXXXXXXXXXXXXXGXXXXXXXXXXXXXXXXXXXXXGOOAAXXXXXXXXXXXXXXXXXGXXXXXXXXXXXXXXXXXXXXXGAXXXXXXXXXXXXXXXXXXXXGXXXXXXXXXXXXXXXXXXXXXGOOAXXXXXXXXXXXXXXXXXXGAXXXXXXXXXXXXXXXXXXXXGOOXXXXXXXXXXXXXXXXXXXGOXXXXXXXXXXXXXXXXXXXXGOOOXXXXXXXXXXXXXXXXXXGOOXXXXXXXXXXXXXXXXXXX,0,444,156

19110,32,6,26,204,209,0,0,394,307,87,GXXXXXXXXXXXXXXXXXXXXXGOAXXXXXXXXXXXXXXXXXXXGXXXXXXXXXXXXXXXXXXXXXGOOAAXXXXXXXXXXXXXXXXXGXXXXXXXXXXXXXXXXXXXXXGAXXXXXXXXXXXXXXXXXXXXGXXXXXXXXXXXXXXXXXXXXXGOOAXXXXXXXXXXXXXXXXXXGAXXXXXXXXXXXXXXXXXXXXGOOXXXXXXXXXXXXXXXXXXXGOXXXXXXXXXXXXXXXXXXXXGOOOXXXXXXXXXXXXXXXXXXGOOXXXXXXXXXXXXXXXXXXX,0,444,156
19131,32,7,25,202,210,0,0,396,306,90,GXXXXXXXXXXXXXXXXXXXXXGOAXXXXXXXXXXXXXXXXXXXGXXXXXXXXXXXXXXXXXXXXXGOOAAXXXXXXXXXXXXXXXXXGXXXXXXXXXXXXXXXXXXXXXGAXXXXXXXXXXXXXXXXXXXXGXXXXXXXXXXXXXXXXXXXXXGOXAAXXXXXXXXXXXXXXXXXGAXXXXXXXXXXXXXXXXXXXXGOOXXXXXXXXXXXXXXXXXXXGOXXXXXXXXXXXXXXXXXXXXGOOOXXXXXXXXXXXXXXXXXXGOOXXXXXXXXXXXXXXXXXXX,0,443,157
19152,30,6,24,200,213,0,0,399,304,95,GXXXXXXXXXXXXXXXXXXXXXGOAAXXXXXXXXXXXXXXXXXXGXXXXXXXXXXXXXXXXXXXXXGOOAAXXXXXXXXXXXXXXXXXGXXXXXXXXXXXXXXXXXXXXXGAXXXXXXXXXXXXXXXXXXXXGXXXXXXXXXXXXXXXXXXXXXGOXXXXXXXXXXXXXXXXXXXXGAXXXXXXXXXXXXXXXXXXXXGOOXXXXXXXXXXXXXXXXXXXGOXXXXXXXXXXXXXXXXXXXXGOXOXXXXXXXXXXXXXXXXXXGOOXXXXXXXXXXXXXXXXXXX,0,442,158
19173,28,6,22,200,214,0,0,399,300,99,GXXXXXXXXXXXXXXXXXXXXXGOAAXXXXXXXXXXXXXXXXXXGXXXXXXXXXXXXXXXXXXXXXGOOAAXXXXXXXXXXXXXXXXXGXXXXXXXXXXXXXXXXXXXXXGAXXXXXXXXXXXXXXXXXXXXGXXXXXXXXXXXXXXXXXXXXXGOXXXXXXXXXXXXXXXXXXXXGAXXXXXXXXXXXXXXXXXXXXGOOXXXXXXXXXXXXXXXXXXXGOXXXXXXXXXXXXXXXXXXXXGOXXXXXXXXXXXXXXXXXXXXGXOXXXXXXXXXXXXXXXXXXX,0,441,159
19194,27,5,22,198,217,0,0,401,305,96,GXXXXXXXXXXXXXXXXXXXXXGOAAXXXXXXXXXXXXXXXXXXGXXXXXXXXXXXXXXXXXXXXXGOOAAXXXXXXXXXXXXXXXXXGXXXXXXXXXXXXXXXXXXXXXGOXXXXXXXXXXXXXXXXXXXXGXXXXXXXXXXXXXXXXXXXXXGOXXXXXXXXXXXXXXXXXXXXGAXXXXXXXXXXXXXXXXXXXXGOOXXXXXXXXXXXXXXXXXXXGOXXXXXXXXXXXXXXXXXXXXGOXXXXXXXXXXXXXXXXXXXXGXXXXXXXXXXXXXXXXXXXXX,0,441,159

19215,27,5,22,194,221,0,0,405,309,96,GXXXXXXXXXXXXXXXXXXXXXGOAAXXXXXXXXXXXXXXXXXXGXXXXXXXXXXXXXXXXXXXXXGOOAAXXXXXXXXXXXXXXXXXGXXXXXXXXXXXXXXXXXXXXXGOXXXXXXXXXXXXXXXXXXXXGXXXXXXXXXXXXXXXXXXXXXGOXXXXXXXXXXXXXXXXXXXXGAXXXXXXXXXXXXXXXXXXXXGOOXXXXXXXXXXXXXXXXXXXGOXXXXXXXXXXXXXXXXXXXXGOXXXXXXXXXXXXXXXXXXXXGXXXXXXXXXXXXXXXXXXXXX,0,441,159
19236,27,5,22,188,227,0,0,411,311,100,GXXXXXXXXXXXXXXXXXXXXXGOAAXXXXXXXXXXXXXXXXXXGXXXXXXXXXXXXXXXXXXXXXGOOAAXXXXXXXXXXXXXXXXXGXXXXXXXXXXXXXXXXXXXXXGOXXXXXXXXXXXXXXXXXXXXGXXXXXXXXXXXXXXXXXXXXXGOXXXXXXXXXXXXXXXXXXXXGAXXXXXXXXXXXXXXXXXXXXGOOXXXXXXXXXXXXXXXXXXXGOXXXXXXXXXXXXXXXXXXXXGOXXXXXXXXXXXXXXXXXXXXGXXXXXXXXXXXXXXXXXXXXX,0,441,159
19257,28,6,22,190,224,0,0,408,313,95,GXXXXXXXXXXXXXXXXXXXXXGOAAXXXXXXXXXXXXXXXXXXGXXXXXXXXXXXXXXXXXXXXXGOOAAXXXXXXXXXXXXXXXXXGXXXXXXXXXXXXXXXXXXXXXGOXXXXXXXXXXXXXXXXXXXXGXXXXXXXXXXXXXXXXXXXXXGOXXXXXXXXXXXXXXXXXXXXGAXXXXXXXXXXXXXXXXXXXXGOOXXXXXXXXXXXXXXXXXXXGOXXXXXXXXXXXXXXXXXXXXGOAXXXXXXXXXXXXXXXXXXXGXXXXXXXXXXXXXXXXXXXXX,0,441,159
19278,27,5,22,194,220,0,0,403,314,89,GXXXXXXXXXXXXXXXXXXXXXGOAAXXXXXXXXXXXXXXXXXXGXXXXXXXXXXXXXXXXXXXXXGOOXAXXXXXXXXXXXXXXXXXGXXXXXXXXXXXXXXXXXXXXXGOXXXXXXXXXXXXXXXXXXXXGXXXXXXXXXXXXXXXXXXXXXGOXXXXXXXXXXXXXXXXXXXXGAXXXXXXXXXXXXXXXXXXXXGOOXXXXXXXXXXXXXXXXXXXGOXXXXXXXXXXXXXXXXXXXXGOAXXXXXXXXXXXXXXXXXXXGXXXXXXXXXXXXXXXXXXXXX,0,440,160
19299,27,5,22,196,218,0,0,402,312,90,GXXXXXXXXXXXXXXXXXXXXXGOAAXXXXXXXXXXXXXXXXXXGXXXXXXXXXXXXXXXXXXXXXGOOXAXXXXXXXXXXXXXXXXXGXXXXXXXXXXXXXXXXXXXXXGOXXXXXXXXXXXXXXXXXXXXGXXXXXXXXXXXXXXXXXXXXXGOXXXXXXXXXXXXXXXXXXXXGAXXXXXXXXXXXXXXXXXXXXGOOXXXXXXXXXXXXXXXXXXXGOXXXXXXXXXXXXXXXXXXXXGOAXXXXXXXXXXXXXXXXXXXGXXXXXXXXXXXXXXXXXXXXX,0,440,160

19320,26,4,22,198,217,0,0,401,312,89,GXXXXXXXXXXXXXXXXXXXXXGOAAXXXXXXXXXXXXXXXXXXGXXXXXXXXXXXXXXXXXXXXXGOOXXXXXXXXXXXXXXXXXXXGXXXXXXXXXXXXXXXXXXXXXGOXXXXXXXXXXXXXXXXXXXXGXXXXXXXXXXXXXXXXXXXXXGOXXXXXXXXXXXXXXXXXXXXGAXXXXXXXXXXXXXXXXXXXXGOOXXXXXXXXXXXXXXXXXXXGOXXXXXXXXXXXXXXXXXXXXGOAXXXXXXXXXXXXXXXXXXXGXXXXXXXXXXXXXXXXXXXXX,0,440,160
19341,26,4,22,195,220,0,0,403,314,89,GXXXXXXXXXXXXXXXXXXXXXGOAAXXXXXXXXXXXXXXXXXXGXXXXXXXXXXXXXXXXXXXXXGOOXXXXXXXXXXXXXXXXXXXGXXXXXXXXXXXXXXXXXXXXXGOXXXXXXXXXXXXXXXXXXXXGXXXXXXXXXXXXXXXXXXXXXGOXXXXXXXXXXXXXXXXXXXXGAXXXXXXXXXXXXXXXXXXXXGOOXXXXXXXXXXXXXXXXXXXGOXXXXXXXXXXXXXXXXXXXXGOAXXXXXXXXXXXXXXXXXXXGXXXXXXXXXXXXXXXXXXXXX,0,440,160
19362,27,5,22,198,216,0,0,400,313,87,GXXXXXXXXXXXXXXXXXXXXXGOAAXXXXXXXXXXXXXXXXXXGXXXXXXXXXXXXXXXXXXXXXGOOXXXXXXXXXXXXXXXXXXXGXXXXXXXXXXXXXXXXXXXXXGOXXXXXXXXXXXXXXXXXXXXGXXXXXXXXXXXXXXXXXXXXXGOXXXXXXXXXXXXXXXXXXXXGAXXXXXXXXXXXXXXXXXXXXGOOXXXXXXXXXXXXXXXXXXXGOAXXXXXXXXXXXXXXXXXXXGOAXXXXXXXXXXXXXXXXXXXGXXXXXXXXXXXXXXXXXXXXX,0,440,160
19383,28,6,22,198,215,0,0,399,314,85,GXXXXXXXXXXXXXXXXXXXXXGOAAXXXXXXXXXXXXXXXXXXGXXXXXXXXXXXXXXXXXXXXXGOOAXXXXXXXXXXXXXXXXXXGXXXXXXXXXXXXXXXXXXXXXGOXXXXXXXXXXXXXXXXXXXXGXXXXXXXXXXXXXXXXXXXXXGOXXXXXXXXXXXXXXXXXXXXGAXXXXXXXXXXXXXXXXXXXXGOOXXXXXXXXXXXXXXXXXXXGOAXXXXXXXXXXXXXXXXXXXGOAXXXXXXXXXXXXXXXXXXXGXXXXXXXXXXXXXXXXXXXXX,0,440,160
19404,28,5,23,202,211,0,0,396,313,83,GXXXXXXXXXXXXXXXXXXXXXGOAAXXXXXXXXXXXXXXXXXXGXXXXXXXXXXXXXXXXXXXXXGOOAXXXXXXXXXXXXXXXXXXGXXXXXXXXXXXXXXXXXXXXXGOXXXXXXXXXXXXXXXXXXXXGXXXXXXXXXXXXXXXXXXXXXGOXXXXXXXXXXXXXXXXXXXXGAXXXXXXXXXXXXXXXXXXXXGOOXXXXXXXXXXXXXXXXXXXGOAXXXXXXXXXXXXXXXXXXXGOOXXXXXXXXXXXXXXXXXXXGXXXXXXXXXXXXXXXXXXXXX,0,440,160

19425,32,9,23,194,215,0,0,400,316,84,GXXXXXXXXXXXXXXXXXXXXXGOAAAXXXXXXXXXXXXXXXXXGXXXXXXXXXXXXXXXXXXXXXGOOAXXXXXXXXXXXXXXXXXXGXXXXXXXXXXXXXXXXXXXXXGOAAXXXXXXXXXXXXXXXXXXGXXXXXXXXXXXXXXXXXXXXXGOXXXXXXXXXXXXXXXXXXXXGAXXXXXXXXXXXXXXXXXXXXGOOAXXXXXXXXXXXXXXXXXXGOAXXXXXXXXXXXXXXXXXXXGOOXXXXXXXXXXXXXXXXXXXGXXXXXXXXXXXXXXXXXXXXX,0,440,160
19446,32,8,24,197,212,0,0,398,316,82,GXXXXXXXXXXXXXXXXXXXXXGOAAAXXXXXXXXXXXXXXXXXGXXXXXXXXXXXXXXXXXXXXXGOOAXXXXXXXXXXXXXXXXXXGXXXXXXXXXXXXXXXXXXXXXGOAAXXXXXXXXXXXXXXXXXXGXXXXXXXXXXXXXXXXXXXXXGOXXXXXXXXXXXXXXXXXXXXGAXXXXXXXXXXXXXXXXXXXXGOOAXXXXXXXXXXXXXXXXXXGOOXXXXXXXXXXXXXXXXXXXGOOXXXXXXXXXXXXXXXXXXXGXXXXXXXXXXXXXXXXXXXXX,0,440,160
19467,32,9,23,196,212,0,0,398,320,78,GXXXXXXXXXXXXXXXXXXXXXGXAAAAXXXXXXXXXXXXXXXXGXXXXXXXXXXXXXXXXXXXXXGOOAXXXXXXXXXXXXXXXXXXGXXXXXXXXXXXXXXXXXXXXXGOAAXXXXXXXXXXXXXXXXXXGXXXXXXXXXXXXXXXXXXXXXGOXXXXXXXXXXXXXXXXXXXXGAXXXXXXXXXXXXXXXXXXXXGOOAXXXXXXXXXXXXXXXXXXGOOXXXXXXXXXXXXXXXXXXXGOOXXXXXXXXXXXXXXXXXXXGXXXXXXXXXXXXXXXXXXXXX,0,439,161
19488,28,5,23,200,212,0,0,398,320,78,GXXXXXXXXXXXXXXXXXXXXXGXXXXXXXXXXXXXXXXXXXXXGXXXXXXXXXXXXXXXXXXXXXGOOAXXXXXXXXXXXXXXXXXXGXXXXXXXXXXXXXXXXXXXXXGOAAXXXXXXXXXXXXXXXXXXGXXXXXXXXXXXXXXXXXXXXXGOXXXXXXXXXXXXXXXXXXXXGAXXXXXXXXXXXXXXXXXXXXGOOAXXXXXXXXXXXXXXXXXXGOOXXXXXXXXXXXXXXXXXXXGOOXXXXXXXXXXXXXXXXXXXGXXXXXXXXXXXXXXXXXXXXX,0,439,161
19509,28,4,24,199,213,0,0,400,321,79,GXXXXXXXXXXXXXXXXXXXXXGXXXXXXXXXXXXXXXXXXXXXGXXXXXXXXXXXXXXXXXXXXXGOOOXXXXXXXXXXXXXXXXXXGXXXXXXXXXXXXXXXXXXXXXGOAAXXXXXXXXXXXXXXXXXXGXXXXXXXXXXXXXXXXXXXXXGOXXXXXXXXXXXXXXXXXXXXGAXXXXXXXXXXXXXXXXXXXXGOOAXXXXXXXXXXXXXXXXXXGOOXXXXXXXXXXXXXXXXXXXGOOXXXXXXXXXXXXXXXXXXXGXXXXXXXXXXXXXXXXXXXXX,0,439,161

19530,28,4,24,199,213,0,0,400,319,81,GXXXXXXXXXXXXXXXXXXXXXGXXXXXXXXXXXXXXXXXXXXXGXXXXXXXXXXXXXXXXXXXXXGOOOXXXXXXXXXXXXXXXXXXGXXXXXXXXXXXXXXXXXXXXXGOAAXXXXXXXXXXXXXXXXXXGXXXXXXXXXXXXXXXXXXXXXGOXXXXXXXXXXXXXXXXXXXXGAXXXXXXXXXXXXXXXXXXXXGOOAXXXXXXXXXXXXXXXXXXGOOXXXXXXXXXXXXXXXXXXXGOOXXXXXXXXXXXXXXXXXXXGXXXXXXXXXXXXXXXXXXXXX,0,439,161
19551,28,4,24,200,212,0,0,399,319,80,GXXXXXXXXXXXXXXXXXXXXXGXXXXXXXXXXXXXXXXXXXXXGXXXXXXXXXXXXXXXXXXXXXGOOOXXXXXXXXXXXXXXXXXXGXXXXXXXXXXXXXXXXXXXXXGOAAXXXXXXXXXXXXXXXXXXGXXXXXXXXXXXXXXXXXXXXXGOXXXXXXXXXXXXXXXXXXXXGAXXXXXXXXXXXXXXXXXXXXGOOAXXXXXXXXXXXXXXXXXXGOOXXXXXXXXXXXXXXXXXXXGOOXXXXXXXXXXXXXXXXXXXGXXXXXXXXXXXXXXXXXXXXX,0,439,161
19572,28,4,24,199,213,0,0,400,322,78,GXXXXXXXXXXXXXXXXXXXXXGXXXXXXXXXXXXXXXXXXXXXGXXXXXXXXXXXXXXXXXXXXXGOOOXXXXXXXXXXXXXXXXXXGXXXXXXXXXXXXXXXXXXXXXGOAAXXXXXXXXXXXXXXXXXXGXXXXXXXXXXXXXXXXXXXXXGOXXXXXXXXXXXXXXXXXXXXGAXXXXXXXXXXXXXXXXXXXXGOOAXXXXXXXXXXXXXXXXXXGOOXXXXXXXXXXXXXXXXXXXGOOXXXXXXXXXXXXXXXXXXXGXXXXXXXXXXXXXXXXXXXXX,0,439,161
19593,28,4,24,195,217,0,0,404,323,81,GXXXXXXXXXXXXXXXXXXXXXGXXXXXXXXXXXXXXXXXXXXXGXXXXXXXXXXXXXXXXXXXXXGOOOXXXXXXXXXXXXXXXXXXGXXXXXXXXXXXXXXXXXXXXXGOAAXXXXXXXXXXXXXXXXXXGXXXXXXXXXXXXXXXXXXXXXGOXXXXXXXXXXXXXXXXXXXXGAXXXXXXXXXXXXXXXXXXXXGOOAXXXXXXXXXXXXXXXXXXGOOXXXXXXXXXXXXXXXXXXXGOOXXXXXXXXXXXXXXXXXXXGXXXXXXXXXXXXXXXXXXXXX,0,439,161
19614,28,4,24,192,220,0,0,407,323,84,GXXXXXXXXXXXXXXXXXXXXXGXXXXXXXXXXXXXXXXXXXXXGXXXXXXXXXXXXXXXXXXXXXGOOOXXXXXXXXXXXXXXXXXXGXXXXXXXXXXXXXXXXXXXXXGOAAXXXXXXXXXXXXXXXXXXGXXXXXXXXXXXXXXXXXXXXXGOXXXXXXXXXXXXXXXXXXXXGAXXXXXXXXXXXXXXXXXXXXGOOAXXXXXXXXXXXXXXXXXXGOOXXXXXXXXXXXXXXXXXXXGOOXXXXXXXXXXXXXXXXXXXGXXXXXXXXXXXXXXXXXXXXX,0,439,161

19635,29,5,24,186,225,0,0,411,328,83,GAXXXXXXXXXXXXXXXXXXXXGXXXXXXXXXXXXXXXXXXXXXGXXXXXXXXXXXXXXXXXXXXXGOOOXXXXXXXXXXXXXXXXXXGXXXXXXXXXXXXXXXXXXXXXGOAAXXXXXXXXXXXXXXXXXXGXXXXXXXXXXXXXXXXXXXXXGOXXXXXXXXXXXXXXXXXXXXGAXXXXXXXXXXXXXXXXXXXXGOOAXXXXXXXXXXXXXXXXXXGOOXXXXXXXXXXXXXXXXXXXGOOXXXXXXXXXXXXXXXXXXXGXXXXXXXXXXXXXXXXXXXXX,0,439,161
19656,28,5,23,186,225,0,0,412,329,83,GAXXXXXXXXXXXXXXXXXXXXGXXXXXXXXXXXXXXXXXXXXXGXXXXXXXXXXXXXXXXXXXXXGOOXXXXXXXXXXXXXXXXXXXGXXXXXXXXXXXXXXXXXXXXXGOAAXXXXXXXXXXXXXXXXXXGXXXXXXXXXXXXXXXXXXXXXGOXXXXXXXXXXXXXXXXXXXXGAXXXXXXXXXXXXXXXXXXXXGOOAXXXXXXXXXXXXXXXXXXGOOXXXXXXXXXXXXXXXXXXXGOOXXXXXXXXXXXXXXXXXXXGXXXXXXXXXXXXXXXXXXXXX,0,438,162
19677,28,5,23,189,222,0,0,409,326,83,GAXXXXXXXXXXXXXXXXXXXXGXXXXXXXXXXXXXXXXXXXXXGXXXXXXXXXXXXXXXXXXXXXGOOXXXXXXXXXXXXXXXXXXXGXXXXXXXXXXXXXXXXXXXXXGOAAXXXXXXXXXXXXXXXXXXGXXXXXXXXXXXXXXXXXXXXXGOXXXXXXXXXXXXXXXXXXXXGAXXXXXXXXXXXXXXXXXXXXGOOAXXXXXXXXXXXXXXXXXXGOOXXXXXXXXXXXXXXXXXXXGOOXXXXXXXXXXXXXXXXXXXGXXXXXXXXXXXXXXXXXXXXX,0,438,162
19698,28,5,23,184,227,0,0,414,327,87,GAXXXXXXXXXXXXXXXXXXXXGXXXXXXXXXXXXXXXXXXXXXGXXXXXXXXXXXXXXXXXXXXXGOOXXXXXXXXXXXXXXXXXXXGXXXXXXXXXXXXXXXXXXXXXGOAAXXXXXXXXXXXXXXXXXXGXXXXXXXXXXXXXXXXXXXXXGOXXXXXXXXXXXXXXXXXXXXGAXXXXXXXXXXXXXXXXXXXXGOOAXXXXXXXXXXXXXXXXXXGOOXXXXXXXXXXXXXXXXXXXGOOXXXXXXXXXXXXXXXXXXXGXXXXXXXXXXXXXXXXXXXXX,0,438,162
19719,29,6,23,179,231,0,0,418,324,94,GAXXXXXXXXXXXXXXXXXXXXGXXXXXXXXXXXXXXXXXXXXXGXXXXXXXXXXXXXXXXXXXXXGOOXXXXXXXXXXXXXXXXXXXGXXXXXXXXXXXXXXXXXXXXXGOAAXXXXXXXXXXXXXXXXXXGXXXXXXXXXXXXXXXXXXXXXGOXXXXXXXXXXXXXXXXXXXXGAXXXXXXXXXXXXXXXXXXXXGOOAAXXXXXXXXXXXXXXXXXGOOXXXXXXXXXXXXXXXXXXXGOOXXXXXXXXXXXXXXXXXXXGXXXXXXXXXXXXXXXXXXXXX,0,438,162

19740,29,6,23,182,228,0,0,414,323,91,GAXXXXXXXXXXXXXXXXXXXXGXXXXXXXXXXXXXXXXXXXXXGXXXXXXXXXXXXXXXXXXXXXGOOXXXXXXXXXXXXXXXXXXXGXXXXXXXXXXXXXXXXXXXXXGOAAXXXXXXXXXXXXXXXXXXGXXXXXXXXXXXXXXXXXXXXXGOXXXXXXXXXXXXXXXXXXXXGAXXXXXXXXXXXXXXXXXXXXGOOAAXXXXXXXXXXXXXXXXXGOOXXXXXXXXXXXXXXXXXXXGOOXXXXXXXXXXXXXXXXXXXGXXXXXXXXXXXXXXXXXXXXX,0,438,162
19761,30,7,23,179,230,0,0,417,320,97,GAXXXXXXXXXXXXXXXXXXXXGXXXXXXXXXXXXXXXXXXXXXGXXXXXXXXXXXXXXXXXXXXXGOOXXXXXXXXXXXXXXXXXXXGAXXXXXXXXXXXXXXXXXXXXGOAAXXXXXXXXXXXXXXXXXXGXXXXXXXXXXXXXXXXXXXXXGOXXXXXXXXXXXXXXXXXXXXGAXXXXXXXXXXXXXXXXXXXXGOOAAXXXXXXXXXXXXXXXXXGOOXXXXXXXXXXXXXXXXXXXGOOXXXXXXXXXXXXXXXXXXXGXXXXXXXXXXXXXXXXXXXXX,0,438,162
19782,29,5,24,176,233,0,0,422,319,103,GOXXXXXXXXXXXXXXXXXXXXGXXXXXXXXXXXXXXXXXXXXXGXXXXXXXXXXXXXXXXXXXXXGOOXXXXXXXXXXXXXXXXXXXGAXXXXXXXXXXXXXXXXXXXXGOAAXXXXXXXXXXXXXXXXXXGXXXXXXXXXXXXXXXXXXXXXGOXXXXXXXXXXXXXXXXXXXXGAXXXXXXXXXXXXXXXXXXXXGOOAOXXXXXXXXXXXXXXXXXGOOXXXXXXXXXXXXXXXXXXXGOXXXXXXXXXXXXXXXXXXXXGXXXXXXXXXXXXXXXXXXXXX,0,437,163
19803,30,6,24,175,233,0,0,422,319,103,GOXXXXXXXXXXXXXXXXXXXXGXXXXXXXXXXXXXXXXXXXXXGXXXXXXXXXXXXXXXXXXXXXGOOXXXXXXXXXXXXXXXXXXXGAXXXXXXXXXXXXXXXXXXXXGOAAXXXXXXXXXXXXXXXXXXGXXXXXXXXXXXXXXXXXXXXXGOXXXXXXXXXXXXXXXXXXXXGAXXXXXXXXXXXXXXXXXXXXGOOAOAXXXXXXXXXXXXXXXXGOOXXXXXXXXXXXXXXXXXXXGOXXXXXXXXXXXXXXXXXXXXGXXXXXXXXXXXXXXXXXXXXX,0,437,163
19824,31,7,24,178,229,0,0,418,321,97,GOXXXXXXXXXXXXXXXXXXXXGXXXXXXXXXXXXXXXXXXXXXGXXXXXXXXXXXXXXXXXXXXXGOOXXXXXXXXXXXXXXXXXXXGAXXXXXXXXXXXXXXXXXXXXGOAAXXXXXXXXXXXXXXXXXXGXXXXXXXXXXXXXXXXXXXXXGOXXXXXXXXXXXXXXXXXXXXGAXXXXXXXXXXXXXXXXXXXXGOOAOAAXXXXXXXXXXXXXXXGOOXXXXXXXXXXXXXXXXXXXGOXXXXXXXXXXXXXXXXXXXXGXXXXXXXXXXXXXXXXXXXXX,0,437,163

19845,31,7,24,175,232,0,0,420,323,97,GOXXXXXXXXXXXXXXXXXXXXGXXXXXXXXXXXXXXXXXXXXXGXXXXXXXXXXXXXXXXXXXXXGOOXXXXXXXXXXXXXXXXXXXGAXXXXXXXXXXXXXXXXXXXXGOAAXXXXXXXXXXXXXXXXXXGXXXXXXXXXXXXXXXXXXXXXGOXXXXXXXXXXXXXXXXXXXXGAXXXXXXXXXXXXXXXXXXXXGOOAOAAXXXXXXXXXXXXXXXGOOXXXXXXXXXXXXXXXXXXXGOXXXXXXXXXXXXXXXXXXXXGXXXXXXXXXXXXXXXXXXXXX,0,437,163
19866,31,7,24,179,228,0,0,417,321,96,GOXXXXXXXXXXXXXXXXXXXXGXXXXXXXXXXXXXXXXXXXXXGXXXXXXXXXXXXXXXXXXXXXGOOXXXXXXXXXXXXXXXXXXXGAXXXXXXXXXXXXXXXXXXXXGOAAXXXXXXXXXXXXXXXXXXGXXXXXXXXXXXXXXXXXXXXXGOXXXXXXXXXXXXXXXXXXXXGAXXXXXXXXXXXXXXXXXXXXGOOAOAAXXXXXXXXXXXXXXXGOOXXXXXXXXXXXXXXXXXXXGOXXXXXXXXXXXXXXXXXXXXGXXXXXXXXXXXXXXXXXXXXX,0,437,163
19887,32,8,24,183,223,0,0,411,317,94,GOXXXXXXXXXXXXXXXXXXXXGXXXXXXXXXXXXXXXXXXXXXGXXXXXXXXXXXXXXXXXXXXXGOOXXXXXXXXXXXXXXXXXXXGAXXXXXXXXXXXXXXXXXXXXGOAAXXXXXXXXXXXXXXXXXXGXXXXXXXXXXXXXXXXXXXXXGOXXXXXXXXXXXXXXXXXXXXGAXXXXXXXXXXXXXXXXXXXXGOOAOAAXXXXXXXXXXXXXXXGOOXXXXXXXXXXXXXXXXXXXGOXXXXXXXXXXXXXXXXXXXXGAXXXXXXXXXXXXXXXXXXXX,0,437,163
19908,31,8,23,182,224,0,0,412,322,90,GOXXXXXXXXXXXXXXXXXXXXGXXXXXXXXXXXXXXXXXXXXXGXXXXXXXXXXXXXXXXXXXXXGOOXXXXXXXXXXXXXXXXXXXGAXXXXXXXXXXXXXXXXXXXXGOAAXXXXXXXXXXXXXXXXXXGXXXXXXXXXXXXXXXXXXXXXGOXXXXXXXXXXXXXXXXXXXXGAXXXXXXXXXXXXXXXXXXXXGOOAXAAXXXXXXXXXXXXXXXGOOXXXXXXXXXXXXXXXXXXXGOXXXXXXXXXXXXXXXXXXXXGAXXXXXXXXXXXXXXXXXXXX,0,436,164
19929,30,7,23,187,220,0,0,408,318,90,GOXXXXXXXXXXXXXXXXXXXXGXXXXXXXXXXXXXXXXXXXXXGXXXXXXXXXXXXXXXXXXXXXGOOXXXXXXXXXXXXXXXXXXXGAXXXXXXXXXXXXXXXXXXXXGOAAXXXXXXXXXXXXXXXXXXGXXXXXXXXXXXXXXXXXXXXXGOXXXXXXXXXXXXXXXXXXXXGAXXXXXXXXXXXXXXXXXXXXGOOAAXXXXXXXXXXXXXXXXXGOOXXXXXXXXXXXXXXXXXXXGOXXXXXXXXXXXXXXXXXXXXGAXXXXXXXXXXXXXXXXXXXX,0,436,164

19950,30,7,23,186,221,0,0,409,320,89,GOXXXXXXXXXXXXXXXXXXXXGXXXXXXXXXXXXXXXXXXXXXGXXXXXXXXXXXXXXXXXXXXXGOOXXXXXXXXXXXXXXXXXXXGAXXXXXXXXXXXXXXXXXXXXGOAAXXXXXXXXXXXXXXXXXXGXXXXXXXXXXXXXXXXXXXXXGOXXXXXXXXXXXXXXXXXXXXGAXXXXXXXXXXXXXXXXXXXXGOOAAXXXXXXXXXXXXXXXXXGOOXXXXXXXXXXXXXXXXXXXGOXXXXXXXXXXXXXXXXXXXXGAXXXXXXXXXXXXXXXXXXXX,0,436,164
19971,30,8,22,184,222,0,0,410,322,88,GOXXXXXXXXXXXXXXXXXXXXGXXXXXXXXXXXXXXXXXXXXXGXXXXXXXXXXXXXXXXXXXXXGOOXXXXXXXXXXXXXXXXXXXGAXXXXXXXXXXXXXXXXXXXXGOAAAXXXXXXXXXXXXXXXXXGXXXXXXXXXXXXXXXXXXXXXGOXXXXXXXXXXXXXXXXXXXXGAXXXXXXXXXXXXXXXXXXXXGOOAAXXXXXXXXXXXXXXXXXGOOXXXXXXXXXXXXXXXXXXXGXXXXXXXXXXXXXXXXXXXXXGAXXXXXXXXXXXXXXXXXXXX,0,435,165
19992,30,8,22,186,220,0,0,408,320,88,GOXXXXXXXXXXXXXXXXXXXXGXXXXXXXXXXXXXXXXXXXXXGXXXXXXXXXXXXXXXXXXXXXGOOXXXXXXXXXXXXXXXXXXXGAXXXXXXXXXXXXXXXXXXXXGOAAAXXXXXXXXXXXXXXXXXGXXXXXXXXXXXXXXXXXXXXXGOXXXXXXXXXXXXXXXXXXXXGAXXXXXXXXXXXXXXXXXXXXGOOAAXXXXXXXXXXXXXXXXXGOOXXXXXXXXXXXXXXXXXXXGXXXXXXXXXXXXXXXXXXXXXGAXXXXXXXXXXXXXXXXXXXX,0,435,165
20013,30,8,22,187,219,0,0,407,322,85,GOXXXXXXXXXXXXXXXXXXXXGXXXXXXXXXXXXXXXXXXXXXGXXXXXXXXXXXXXXXXXXXXXGOOXXXXXXXXXXXXXXXXXXXGAXXXXXXXXXXXXXXXXXXXXGOAAAXXXXXXXXXXXXXXXXXGXXXXXXXXXXXXXXXXXXXXXGOXXXXXXXXXXXXXXXXXXXXGAXXXXXXXXXXXXXXXXXXXXGOOAAXXXXXXXXXXXXXXXXXGOOXXXXXXXXXXXXXXXXXXXGXXXXXXXXXXXXXXXXXXXXXGAXXXXXXXXXXXXXXXXXXXX,0,435,165
20034,30,8,22,186,220,0,0,408,325,83,GOXXXXXXXXXXXXXXXXXXXXGXXXXXXXXXXXXXXXXXXXXXGXXXXXXXXXXXXXXXXXXXXXGOOXXXXXXXXXXXXXXXXXXXGAXXXXXXXXXXXXXXXXXXXXGOAAAXXXXXXXXXXXXXXXXXGXXXXXXXXXXXXXXXXXXXXXGOXXXXXXXXXXXXXXXXXXXXGAXXXXXXXXXXXXXXXXXXXXGOOAAXXXXXXXXXXXXXXXXXGOOXXXXXXXXXXXXXXXXXXXGXXXXXXXXXXXXXXXXXXXXXGAXXXXXXXXXXXXXXXXXXXX,0,435,165

20055,30,8,22,186,220,0,0,408,323,85,GOXXXXXXXXXXXXXXXXXXXXGXXXXXXXXXXXXXXXXXXXXXGXXXXXXXXXXXXXXXXXXXXXGOOXXXXXXXXXXXXXXXXXXXGAXXXXXXXXXXXXXXXXXXXXGOAAAXXXXXXXXXXXXXXXXXGXXXXXXXXXXXXXXXXXXXXXGOXXXXXXXXXXXXXXXXXXXXGAXXXXXXXXXXXXXXXXXXXXGOOAAXXXXXXXXXXXXXXXXXGOOXXXXXXXXXXXXXXXXXXXGXXXXXXXXXXXXXXXXXXXXXGAXXXXXXXXXXXXXXXXXXXX,0,435,165
20076,29,7,22,188,218,0,0,407,323,84,GOXXXXXXXXXXXXXXXXXXXXGXXXXXXXXXXXXXXXXXXXXXGXXXXXXXXXXXXXXXXXXXXXGOOXXXXXXXXXXXXXXXXXXXGAXXXXXXXXXXXXXXXXXXXXGOAAOXXXXXXXXXXXXXXXXXGXXXXXXXXXXXXXXXXXXXXXGOXXXXXXXXXXXXXXXXXXXXGAXXXXXXXXXXXXXXXXXXXXGOOAAXXXXXXXXXXXXXXXXXGOXXXXXXXXXXXXXXXXXXXXGXXXXXXXXXXXXXXXXXXXXXGAXXXXXXXXXXXXXXXXXXXX,0,434,166
20097,30,8,22,189,216,0,0,405,323,82,GOXXXXXXXXXXXXXXXXXXXXGXXXXXXXXXXXXXXXXXXXXXGAXXXXXXXXXXXXXXXXXXXXGOOXXXXXXXXXXXXXXXXXXXGAXXXXXXXXXXXXXXXXXXXXGOAAOXXXXXXXXXXXXXXXXXGXXXXXXXXXXXXXXXXXXXXXGOXXXXXXXXXXXXXXXXXXXXGAXXXXXXXXXXXXXXXXXXXXGOOAAXXXXXXXXXXXXXXXXXGOXXXXXXXXXXXXXXXXXXXXGXXXXXXXXXXXXXXXXXXXXXGAXXXXXXXXXXXXXXXXXXXX,0,434,166
20118,30,8,22,185,220,0,0,409,323,86,GOXXXXXXXXXXXXXXXXXXXXGXXXXXXXXXXXXXXXXXXXXXGAXXXXXXXXXXXXXXXXXXXXGOOXXXXXXXXXXXXXXXXXXXGAXXXXXXXXXXXXXXXXXXXXGOAAOXXXXXXXXXXXXXXXXXGXXXXXXXXXXXXXXXXXXXXXGOXXXXXXXXXXXXXXXXXXXXGAXXXXXXXXXXXXXXXXXXXXGOOAAXXXXXXXXXXXXXXXXXGOXXXXXXXXXXXXXXXXXXXXGXXXXXXXXXXXXXXXXXXXXXGAXXXXXXXXXXXXXXXXXXXX,0,434,166
20139,32,10,22,188,215,0,0,404,325,79,GOXXXXXXXXXXXXXXXXXXXXGXXXXXXXXXXXXXXXXXXXXXGAXXXXXXXXXXXXXXXXXXXXGOOXXXXXXXXXXXXXXXXXXXGAXXXXXXXXXXXXXXXXXXXXGOAAOAXXXXXXXXXXXXXXXXGXXXXXXXXXXXXXXXXXXXXXGOXXXXXXXXXXXXXXXXXXXXGAXXXXXXXXXXXXXXXXXXXXGOOAAXXXXXXXXXXXXXXXXXGOXXXXXXXXXXXXXXXXXXXXGXXXXXXXXXXXXXXXXXXXXXGAAXXXXXXXXXXXXXXXXXXX,0,434,166

20160,31,10,21,183,220,0,0,409,330,79,GOXXXXXXXXXXXXXXXXXXXXGXXXXXXXXXXXXXXXXXXXXXGAXXXXXXXXXXXXXXXXXXXXGOOXXXXXXXXXXXXXXXXXXXGAXXXXXXXXXXXXXXXXXXXXGOAAOAXXXXXXXXXXXXXXXXGXXXXXXXXXXXXXXXXXXXXXGOXXXXXXXXXXXXXXXXXXXXGAXXXXXXXXXXXXXXXXXXXXGOXAAXXXXXXXXXXXXXXXXXGOXXXXXXXXXXXXXXXXXXXXGXXXXXXXXXXXXXXXXXXXXXGAAXXXXXXXXXXXXXXXXXXX,0,433,167
20181,31,10,21,183,220,0,0,409,330,79,GOXXXXXXXXXXXXXXXXXXXXGXXXXXXXXXXXXXXXXXXXXXGAXXXXXXXXXXXXXXXXXXXXGOOXXXXXXXXXXXXXXXXXXXGAXXXXXXXXXXXXXXXXXXXXGOAAOAXXXXXXXXXXXXXXXXGXXXXXXXXXXXXXXXXXXXXXGOXXXXXXXXXXXXXXXXXXXXGAXXXXXXXXXXXXXXXXXXXXGOXAAXXXXXXXXXXXXXXXXXGOXXXXXXXXXXXXXXXXXXXXGXXXXXXXXXXXXXXXXXXXXXGAAXXXXXXXXXXXXXXXXXXX,0,433,167
20202,30,9,21,184,220,0,0,409,331,78,GOXXXXXXXXXXXXXXXXXXXXGXXXXXXXXXXXXXXXXXXXXXGAXXXXXXXXXXXXXXXXXXXXGOOXXXXXXXXXXXXXXXXXXXGAXXXXXXXXXXXXXXXXXXXXGOAAOAXXXXXXXXXXXXXXXXGAXXXXXXXXXXXXXXXXXXXXGOXXXXXXXXXXXXXXXXXXXXGAXXXXXXXXXXXXXXXXXXXXGOXXXXXXXXXXXXXXXXXXXXGOXXXXXXXXXXXXXXXXXXXXGXXXXXXXXXXXXXXXXXXXXXGAAXXXXXXXXXXXXXXXXXXX,0,433,167
20223,30,7,23,185,219,0,0,409,330,79,GOXXXXXXXXXXXXXXXXXXXXGXXXXXXXXXXXXXXXXXXXXXGAXXXXXXXXXXXXXXXXXXXXGOOXXXXXXXXXXXXXXXXXXXGAXXXXXXXXXXXXXXXXXXXXGOOAOAXXXXXXXXXXXXXXXXGAXXXXXXXXXXXXXXXXXXXXGOXXXXXXXXXXXXXXXXXXXXGAXXXXXXXXXXXXXXXXXXXXGOXXXXXXXXXXXXXXXXXXXXGOXXXXXXXXXXXXXXXXXXXXGXXXXXXXXXXXXXXXXXXXXXGAOXXXXXXXXXXXXXXXXXXX,0,433,167
20244,30,7,23,186,218,0,0,409,331,78,GOXXXXXXXXXXXXXXXXXXXXGXXXXXXXXXXXXXXXXXXXXXGAXXXXXXXXXXXXXXXXXXXXGOOXXXXXXXXXXXXXXXXXXXGAXXXXXXXXXXXXXXXXXXXXGOOAOAXXXXXXXXXXXXXXXXGAXXXXXXXXXXXXXXXXXXXXGOXXXXXXXXXXXXXXXXXXXXGAXXXXXXXXXXXXXXXXXXXXGOXXXXXXXXXXXXXXXXXXXXGOXXXXXXXXXXXXXXXXXXXXGXXXXXXXXXXXXXXXXXXXXXGAOXXXXXXXXXXXXXXXXXXX,0,433,167

20265,29,7,22,187,217,0,0,408,334,74,GXXXXXXXXXXXXXXXXXXXXXGXXXXXXXXXXXXXXXXXXXXXGAXXXXXXXXXXXXXXXXXXXXGOOXXXXXXXXXXXXXXXXXXXGAXXXXXXXXXXXXXXXXXXXXGOOAOAXXXXXXXXXXXXXXXXGAXXXXXXXXXXXXXXXXXXXXGOXXXXXXXXXXXXXXXXXXXXGAXXXXXXXXXXXXXXXXXXXXGOXXXXXXXXXXXXXXXXXXXXGOXXXXXXXXXXXXXXXXXXXXGXXXXXXXXXXXXXXXXXXXXXGAOXXXXXXXXXXXXXXXXXXX,0,432,168
20286,28,6,22,188,216,0,0,408,328,80,GXXXXXXXXXXXXXXXXXXXXXGXXXXXXXXXXXXXXXXXXXXXGAXXXXXXXXXXXXXXXXXXXXGOXXXXXXXXXXXXXXXXXXXXGAXXXXXXXXXXXXXXXXXXXXGOOAOAXXXXXXXXXXXXXXXXGAXXXXXXXXXXXXXXXXXXXXGOXXXXXXXXXXXXXXXXXXXXGOXXXXXXXXXXXXXXXXXXXXGOXXXXXXXXXXXXXXXXXXXXGOXXXXXXXXXXXXXXXXXXXXGXXXXXXXXXXXXXXXXXXXXXGAOXXXXXXXXXXXXXXXXXXX,0,431,169
20307,29,7,22,189,214,0,0,406,325,81,GXXXXXXXXXXXXXXXXXXXXXGXXXXXXXXXXXXXXXXXXXXXGAXXXXXXXXXXXXXXXXXXXXGOXXXXXXXXXXXXXXXXXXXXGAXXXXXXXXXXXXXXXXXXXXGOOAOAAXXXXXXXXXXXXXXXGAXXXXXXXXXXXXXXXXXXXXGOXXXXXXXXXXXXXXXXXXXXGOXXXXXXXXXXXXXXXXXXXXGOXXXXXXXXXXXXXXXXXXXXGOXXXXXXXXXXXXXXXXXXXXGXXXXXXXXXXXXXXXXXXXXXGAOXXXXXXXXXXXXXXXXXXX,0,431,169
20328,29,7,22,188,215,0,0,409,329,80,GXXXXXXXXXXXXXXXXXXXXXGXXXXXXXXXXXXXXXXXXXXXGAXXXXXXXXXXXXXXXXXXXXGOXXXXXXXXXXXXXXXXXXXXGAXXXXXXXXXXXXXXXXXXXXGOOAOAAXXXXXXXXXXXXXXXGAXXXXXXXXXXXXXXXXXXXXGOXXXXXXXXXXXXXXXXXXXXGOXXXXXXXXXXXXXXXXXXXXGOXXXXXXXXXXXXXXXXXXXXGOXXXXXXXXXXXXXXXXXXXXGXXXXXXXXXXXXXXXXXXXXXGAOXXXXXXXXXXXXXXXXXXX,0,431,169
20349,29,6,23,184,219,0,0,413,327,86,GXXXXXXXXXXXXXXXXXXXXXGXXXXXXXXXXXXXXXXXXXXXGAXXXXXXXXXXXXXXXXXXXXGOXXXXXXXXXXXXXXXXXXXXGAXXXXXXXXXXXXXXXXXXXXGOOOOAAXXXXXXXXXXXXXXXGAXXXXXXXXXXXXXXXXXXXXGOXXXXXXXXXXXXXXXXXXXXGOXXXXXXXXXXXXXXXXXXXXGOXXXXXXXXXXXXXXXXXXXXGOXXXXXXXXXXXXXXXXXXXXGXXXXXXXXXXXXXXXXXXXXXGAOXXXXXXXXXXXXXXXXXXX,0,431,169

20370,29,6,23,188,215,0,0,410,325,85,GXXXXXXXXXXXXXXXXXXXXXGXXXXXXXXXXXXXXXXXXXXXGAXXXXXXXXXXXXXXXXXXXXGOXXXXXXXXXXXXXXXXXXXXGAXXXXXXXXXXXXXXXXXXXXGOOOOAAXXXXXXXXXXXXXXXGAXXXXXXXXXXXXXXXXXXXXGOXXXXXXXXXXXXXXXXXXXXGOXXXXXXXXXXXXXXXXXXXXGOXXXXXXXXXXXXXXXXXXXXGOXXXXXXXXXXXXXXXXXXXXGXXXXXXXXXXXXXXXXXXXXXGAOXXXXXXXXXXXXXXXXXXX,0,431,169
20391,29,5,24,183,220,0,0,415,329,86,GXXXXXXXXXXXXXXXXXXXXXGXXXXXXXXXXXXXXXXXXXXXGAXXXXXXXXXXXXXXXXXXXXGOXXXXXXXXXXXXXXXXXXXXGOXXXXXXXXXXXXXXXXXXXXGOOOOAAXXXXXXXXXXXXXXXGAXXXXXXXXXXXXXXXXXXXXGOXXXXXXXXXXXXXXXXXXXXGOXXXXXXXXXXXXXXXXXXXXGOXXXXXXXXXXXXXXXXXXXXGOXXXXXXXXXXXXXXXXXXXXGXXXXXXXXXXXXXXXXXXXXXGAOXXXXXXXXXXXXXXXXXXX,0,431,169
20412,29,5,24,190,213,0,0,409,323,86,GXXXXXXXXXXXXXXXXXXXXXGXXXXXXXXXXXXXXXXXXXXXGAXXXXXXXXXXXXXXXXXXXXGOXXXXXXXXXXXXXXXXXXXXGOXXXXXXXXXXXXXXXXXXXXGOOOOAAXXXXXXXXXXXXXXXGAXXXXXXXXXXXXXXXXXXXXGOXXXXXXXXXXXXXXXXXXXXGOXXXXXXXXXXXXXXXXXXXXGOXXXXXXXXXXXXXXXXXXXXGOXXXXXXXXXXXXXXXXXXXXGXXXXXXXXXXXXXXXXXXXXXGAOXXXXXXXXXXXXXXXXXXX,0,431,169
20433,29,4,25,187,216,0,0,413,327,86,GXXXXXXXXXXXXXXXXXXXXXGXXXXXXXXXXXXXXXXXXXXXGOXXXXXXXXXXXXXXXXXXXXGOXXXXXXXXXXXXXXXXXXXXGOXXXXXXXXXXXXXXXXXXXXGOOOOAAXXXXXXXXXXXXXXXGAXXXXXXXXXXXXXXXXXXXXGOXXXXXXXXXXXXXXXXXXXXGOXXXXXXXXXXXXXXXXXXXXGOXXXXXXXXXXXXXXXXXXXXGOXXXXXXXXXXXXXXXXXXXXGXXXXXXXXXXXXXXXXXXXXXGAOXXXXXXXXXXXXXXXXXXX,0,431,169
20454,29,4,25,186,217,0,0,414,327,87,GXXXXXXXXXXXXXXXXXXXXXGXXXXXXXXXXXXXXXXXXXXXGOXXXXXXXXXXXXXXXXXXXXGOXXXXXXXXXXXXXXXXXXXXGOXXXXXXXXXXXXXXXXXXXXGOOOOAAXXXXXXXXXXXXXXXGAXXXXXXXXXXXXXXXXXXXXGOXXXXXXXXXXXXXXXXXXXXGOXXXXXXXXXXXXXXXXXXXXGOXXXXXXXXXXXXXXXXXXXXGOXXXXXXXXXXXXXXXXXXXXGXXXXXXXXXXXXXXXXXXXXXGAOXXXXXXXXXXXXXXXXXXX,0,431,169

20475,30,5,25,184,218,0,0,414,331,83,GXXXXXXXXXXXXXXXXXXXXXGXXXXXXXXXXXXXXXXXXXXXGOXXXXXXXXXXXXXXXXXXXXGOXXXXXXXXXXXXXXXXXXXXGOXXXXXXXXXXXXXXXXXXXXGOOOOAAXXXXXXXXXXXXXXXGAXXXXXXXXXXXXXXXXXXXXGOXXXXXXXXXXXXXXXXXXXXGOXXXXXXXXXXXXXXXXXXXXGOXXXXXXXXXXXXXXXXXXXXGOXXXXXXXXXXXXXXXXXXXXGXXXXXXXXXXXXXXXXXXXXXGAOAXXXXXXXXXXXXXXXXXX,0,431,169
20496,30,5,25,185,217,0,0,412,338,74,GXXXXXXXXXXXXXXXXXXXXXGXXXXXXXXXXXXXXXXXXXXXGOXXXXXXXXXXXXXXXXXXXXGOXXXXXXXXXXXXXXXXXXXXGOXXXXXXXXXXXXXXXXXXXXGOOOOAAXXXXXXXXXXXXXXXGAXXXXXXXXXXXXXXXXXXXXGOXXXXXXXXXXXXXXXXXXXXGOXXXXXXXXXXXXXXXXXXXXGOXXXXXXXXXXXXXXXXXXXXGOXXXXXXXXXXXXXXXXXXXXGXXXXXXXXXXXXXXXXXXXXXGAOAXXXXXXXXXXXXXXXXXX,0,431,169
20517,30,5,25,188,214,0,0,410,335,75,GXXXXXXXXXXXXXXXXXXXXXGXXXXXXXXXXXXXXXXXXXXXGOXXXXXXXXXXXXXXXXXXXXGOXXXXXXXXXXXXXXXXXXXXGOXXXXXXXXXXXXXXXXXXXXGOOOOAAXXXXXXXXXXXXXXXGAXXXXXXXXXXXXXXXXXXXXGOXXXXXXXXXXXXXXXXXXXXGOXXXXXXXXXXXXXXXXXXXXGOXXXXXXXXXXXXXXXXXXXXGOXXXXXXXXXXXXXXXXXXXXGXXXXXXXXXXXXXXXXXXXXXGAOAXXXXXXXXXXXXXXXXXX,0,431,169
20538,30,5,25,186,216,0,0,412,333,79,GXXXXXXXXXXXXXXXXXXXXXGXXXXXXXXXXXXXXXXXXXXXGOXXXXXXXXXXXXXXXXXXXXGOXXXXXXXXXXXXXXXXXXXXGOXXXXXXXXXXXXXXXXXXXXGOOOOAAXXXXXXXXXXXXXXXGAXXXXXXXXXXXXXXXXXXXXGOXXXXXXXXXXXXXXXXXXXXGOXXXXXXXXXXXXXXXXXXXXGOXXXXXXXXXXXXXXXXXXXXGOXXXXXXXXXXXXXXXXXXXXGXXXXXXXXXXXXXXXXXXXXXGAOAXXXXXXXXXXXXXXXXXX,0,431,169
20559,31,5,26,185,216,0,0,412,328,84,GXXXXXXXXXXXXXXXXXXXXXGXXXXXXXXXXXXXXXXXXXXXGOXXXXXXXXXXXXXXXXXXXXGOXXXXXXXXXXXXXXXXXXXXGOAXXXXXXXXXXXXXXXXXXXGOOOOAAXXXXXXXXXXXXXXXGAXXXXXXXXXXXXXXXXXXXXGOXXXXXXXXXXXXXXXXXXXXGOXXXXXXXXXXXXXXXXXXXXGOXXXXXXXXXXXXXXXXXXXXGOXXXXXXXXXXXXXXXXXXXXGXXXXXXXXXXXXXXXXXXXXXGOOAXXXXXXXXXXXXXXXXXX,0,431,169

20580,31,5,26,181,220,0,0,415,330,85,GXXXXXXXXXXXXXXXXXXXXXGXXXXXXXXXXXXXXXXXXXXXGOXXXXXXXXXXXXXXXXXXXXGOXXXXXXXXXXXXXXXXXXXXGOAXXXXXXXXXXXXXXXXXXXGOOOOAAXXXXXXXXXXXXXXXGAXXXXXXXXXXXXXXXXXXXXGOXXXXXXXXXXXXXXXXXXXXGOXXXXXXXXXXXXXXXXXXXXGOXXXXXXXXXXXXXXXXXXXXGOXXXXXXXXXXXXXXXXXXXXGXXXXXXXXXXXXXXXXXXXXXGOOAXXXXXXXXXXXXXXXXXX,0,431,169
20601,31,5,26,185,216,0,0,413,324,89,GXXXXXXXXXXXXXXXXXXXXXGXXXXXXXXXXXXXXXXXXXXXGOXXXXXXXXXXXXXXXXXXXXGOXXXXXXXXXXXXXXXXXXXXGOAXXXXXXXXXXXXXXXXXXXGOOOOAAXXXXXXXXXXXXXXXGAXXXXXXXXXXXXXXXXXXXXGOXXXXXXXXXXXXXXXXXXXXGOXXXXXXXXXXXXXXXXXXXXGOXXXXXXXXXXXXXXXXXXXXGOXXXXXXXXXXXXXXXXXXXXGXXXXXXXXXXXXXXXXXXXXXGOOAXXXXXXXXXXXXXXXXXX,0,431,169
20622,33,7,26,183,216,0,0,413,329,84,GXXXXXXXXXXXXXXXXXXXXXGXXXXXXXXXXXXXXXXXXXXXGOXXXXXXXXXXXXXXXXXXXXGOXXXXXXXXXXXXXXXXXXXXGOAXXXXXXXXXXXXXXXXXXXGOOOOAAXXXXXXXXXXXXXXXGAXXXXXXXXXXXXXXXXXXXXGOXXXXXXXXXXXXXXXXXXXXGOXXXXXXXXXXXXXXXXXXXXGOXXXXXXXXXXXXXXXXXXXXGOXXXXXXXXXXXXXXXXXXXXGXXXXXXXXXXXXXXXXXXXXXGOOAAAXXXXXXXXXXXXXXXX,0,431,169
20643,34,8,26,186,212,0,0,409,328,81,GXXXXXXXXXXXXXXXXXXXXXGXXXXXXXXXXXXXXXXXXXXXGOXXXXXXXXXXXXXXXXXXXXGOXXXXXXXXXXXXXXXXXXXXGOAXXXXXXXXXXXXXXXXXXXGOOOOAAXXXXXXXXXXXXXXXGAXXXXXXXXXXXXXXXXXXXXGOXXXXXXXXXXXXXXXXXXXXGOXXXXXXXXXXXXXXXXXXXXGOXXXXXXXXXXXXXXXXXXXXGOXXXXXXXXXXXXXXXXXXXXGXXXXXXXXXXXXXXXXXXXXXGOOAAAAXXXXXXXXXXXXXXX,0,431,169
20664,35,9,26,183,214,0,0,411,330,81,GXXXXXXXXXXXXXXXXXXXXXGXXXXXXXXXXXXXXXXXXXXXGOXXXXXXXXXXXXXXXXXXXXGOXXXXXXXXXXXXXXXXXXXXGOAXXXXXXXXXXXXXXXXXXXGOOOOAAXXXXXXXXXXXXXXXGAAXXXXXXXXXXXXXXXXXXXGOXXXXXXXXXXXXXXXXXXXXGOXXXXXXXXXXXXXXXXXXXXGOXXXXXXXXXXXXXXXXXXXXGOXXXXXXXXXXXXXXXXXXXXGXXXXXXXXXXXXXXXXXXXXXGOOAAAAXXXXXXXXXXXXXXX,0,431,169

20685,35,9,26,189,208,0,0,405,328,77,GXXXXXXXXXXXXXXXXXXXXXGXXXXXXXXXXXXXXXXXXXXXGOXXXXXXXXXXXXXXXXXXXXGOXXXXXXXXXXXXXXXXXXXXGOAXXXXXXXXXXXXXXXXXXXGOOOOAAXXXXXXXXXXXXXXXGAAXXXXXXXXXXXXXXXXXXXGOXXXXXXXXXXXXXXXXXXXXGOXXXXXXXXXXXXXXXXXXXXGOXXXXXXXXXXXXXXXXXXXXGOXXXXXXXXXXXXXXXXXXXXGXXXXXXXXXXXXXXXXXXXXXGOOAAAAXXXXXXXXXXXXXXX,0,431,169
20706,35,8,27,190,207,0,0,405,328,77,GXXXXXXXXXXXXXXXXXXXXXGXXXXXXXXXXXXXXXXXXXXXGOXXXXXXXXXXXXXXXXXXXXGOXXXXXXXXXXXXXXXXXXXXGOAXXXXXXXXXXXXXXXXXXXGOOOOAAXXXXXXXXXXXXXXXGAAXXXXXXXXXXXXXXXXXXXGOXXXXXXXXXXXXXXXXXXXXGOXXXXXXXXXXXXXXXXXXXXGOXXXXXXXXXXXXXXXXXXXXGOXXXXXXXXXXXXXXXXXXXXGXXXXXXXXXXXXXXXXXXXXXGOOAAOAXXXXXXXXXXXXXXX,0,431,169
20727,35,8,27,192,205,0,0,403,326,77,GXXXXXXXXXXXXXXXXXXXXXGXXXXXXXXXXXXXXXXXXXXXGOXXXXXXXXXXXXXXXXXXXXGOXXXXXXXXXXXXXXXXXXXXGOAXXXXXXXXXXXXXXXXXXXGOOOOAAXXXXXXXXXXXXXXXGAAXXXXXXXXXXXXXXXXXXXGOXXXXXXXXXXXXXXXXXXXXGOXXXXXXXXXXXXXXXXXXXXGOXXXXXXXXXXXXXXXXXXXXGOXXXXXXXXXXXXXXXXXXXXGXXXXXXXXXXXXXXXXXXXXXGOOAAOAXXXXXXXXXXXXXXX,0,431,169
20748,35,7,28,188,209,0,0,407,325,82,GXXXXXXXXXXXXXXXXXXXXXGXXXXXXXXXXXXXXXXXXXXXGOXXXXXXXXXXXXXXXXXXXXGOXXXXXXXXXXXXXXXXXXXXGOAXXXXXXXXXXXXXXXXXXXGOOOOAAXXXXXXXXXXXXXXXGAAXXXXXXXXXXXXXXXXXXXGOXXXXXXXXXXXXXXXXXXXXGOXXXXXXXXXXXXXXXXXXXXGOXXXXXXXXXXXXXXXXXXXXGOXXXXXXXXXXXXXXXXXXXXGXXXXXXXXXXXXXXXXXXXXXGOOAAOOXXXXXXXXXXXXXXX,0,431,169
20769,35,7,28,185,212,0,0,410,328,82,GXXXXXXXXXXXXXXXXXXXXXGXXXXXXXXXXXXXXXXXXXXXGOXXXXXXXXXXXXXXXXXXXXGOXXXXXXXXXXXXXXXXXXXXGOAXXXXXXXXXXXXXXXXXXXGOOOOAAXXXXXXXXXXXXXXXGAAXXXXXXXXXXXXXXXXXXXGOXXXXXXXXXXXXXXXXXXXXGOXXXXXXXXXXXXXXXXXXXXGOXXXXXXXXXXXXXXXXXXXXGOXXXXXXXXXXXXXXXXXXXXGXXXXXXXXXXXXXXXXXXXXXGOOAAOOXXXXXXXXXXXXXXX,0,431,169

20790,35,6,29,184,213,0,0,411,331,80,GXXXXXXXXXXXXXXXXXXXXXGXXXXXXXXXXXXXXXXXXXXXGOXXXXXXXXXXXXXXXXXXXXGOXXXXXXXXXXXXXXXXXXXXGOAXXXXXXXXXXXXXXXXXXXGOOOOAAXXXXXXXXXXXXXXXGOAXXXXXXXXXXXXXXXXXXXGOXXXXXXXXXXXXXXXXXXXXGOXXXXXXXXXXXXXXXXXXXXGOXXXXXXXXXXXXXXXXXXXXGOXXXXXXXXXXXXXXXXXXXXGXXXXXXXXXXXXXXXXXXXXXGOOAAOOXXXXXXXXXXXXXXX,0,431,169
20811,35,7,28,180,216,0,0,415,327,88,GXXXXXXXXXXXXXXXXXXXXXGXXXXXXXXXXXXXXXXXXXXXGOXXXXXXXXXXXXXXXXXXXXGOXXXXXXXXXXXXXXXXXXXXGOAXXXXXXXXXXXXXXXXXXXGOOOOAAXXXXXXXXXXXXXXXGXAXXXXXXXXXXXXXXXXXXXGOXXXXXXXXXXXXXXXXXXXXGOXXXXXXXXXXXXXXXXXXXXGOXXXXXXXXXXXXXXXXXXXXGOAXXXXXXXXXXXXXXXXXXXGXXXXXXXXXXXXXXXXXXXXXGOOAAOOXXXXXXXXXXXXXXX,0,430,170
20832,35,5,30,177,219,0,0,419,331,88,GXXXXXXXXXXXXXXXXXXXXXGXXXXXXXXXXXXXXXXXXXXXGOXXXXXXXXXXXXXXXXXXXXGOXXXXXXXXXXXXXXXXXXXXGOOXXXXXXXXXXXXXXXXXXXGOOOOOAXXXXXXXXXXXXXXXGXAXXXXXXXXXXXXXXXXXXXGOXXXXXXXXXXXXXXXXXXXXGOXXXXXXXXXXXXXXXXXXXXGOXXXXXXXXXXXXXXXXXXXXGOAXXXXXXXXXXXXXXXXXXXGXXXXXXXXXXXXXXXXXXXXXGOOAAOOXXXXXXXXXXXXXXX,0,430,170
20853,36,6,30,177,218,0,0,417,330,87,GXXXXXXXXXXXXXXXXXXXXXGXXXXXXXXXXXXXXXXXXXXXGOXXXXXXXXXXXXXXXXXXXXGOXXXXXXXXXXXXXXXXXXXXGOOAXXXXXXXXXXXXXXXXXXGOOOOOAXXXXXXXXXXXXXXXGXAXXXXXXXXXXXXXXXXXXXGOXXXXXXXXXXXXXXXXXXXXGOXXXXXXXXXXXXXXXXXXXXGOXXXXXXXXXXXXXXXXXXXXGOAXXXXXXXXXXXXXXXXXXXGXXXXXXXXXXXXXXXXXXXXXGOOAAOOXXXXXXXXXXXXXXX,0,430,170
20874,37,7,30,175,219,0,0,419,331,88,GXXXXXXXXXXXXXXXXXXXXXGXXXXXXXXXXXXXXXXXXXXXGOXXXXXXXXXXXXXXXXXXXXGOXXXXXXXXXXXXXXXXXXXXGOOAAXXXXXXXXXXXXXXXXXGOOOOOAXXXXXXXXXXXXXXXGXAXXXXXXXXXXXXXXXXXXXGOXXXXXXXXXXXXXXXXXXXXGOXXXXXXXXXXXXXXXXXXXXGOXXXXXXXXXXXXXXXXXXXXGOAXXXXXXXXXXXXXXXXXXXGXXXXXXXXXXXXXXXXXXXXXGOOAAOOXXXXXXXXXXXXXXX,0,430,170

20895,38,8,30,172,221,0,0,421,332,89,GXXXXXXXXXXXXXXXXXXXXXGXXXXXXXXXXXXXXXXXXXXXGOXXXXXXXXXXXXXXXXXXXXGOAXXXXXXXXXXXXXXXXXXXGOOAAXXXXXXXXXXXXXXXXXGOOOOOAXXXXXXXXXXXXXXXGXAXXXXXXXXXXXXXXXXXXXGOXXXXXXXXXXXXXXXXXXXXGOXXXXXXXXXXXXXXXXXXXXGOXXXXXXXXXXXXXXXXXXXXGOAXXXXXXXXXXXXXXXXXXXGXXXXXXXXXXXXXXXXXXXXXGOOAAOOXXXXXXXXXXXXXXX,0,430,170
20916,38,8,30,168,225,0,0,424,332,92,GXXXXXXXXXXXXXXXXXXXXXGXXXXXXXXXXXXXXXXXXXXXGOXXXXXXXXXXXXXXXXXXXXGOAXXXXXXXXXXXXXXXXXXXGOOAAXXXXXXXXXXXXXXXXXGOOOOOAXXXXXXXXXXXXXXXGXAXXXXXXXXXXXXXXXXXXXGOXXXXXXXXXXXXXXXXXXXXGOXXXXXXXXXXXXXXXXXXXXGOXXXXXXXXXXXXXXXXXXXXGOAXXXXXXXXXXXXXXXXXXXGXXXXXXXXXXXXXXXXXXXXXGOOAAOOXXXXXXXXXXXXXXX,0,430,170
20937,38,8,30,167,226,0,0,426,335,91,GXXXXXXXXXXXXXXXXXXXXXGXXXXXXXXXXXXXXXXXXXXXGOXXXXXXXXXXXXXXXXXXXXGOAXXXXXXXXXXXXXXXXXXXGOOAAXXXXXXXXXXXXXXXXXGOOOOOAXXXXXXXXXXXXXXXGXAXXXXXXXXXXXXXXXXXXXGOXXXXXXXXXXXXXXXXXXXXGOXXXXXXXXXXXXXXXXXXXXGOXXXXXXXXXXXXXXXXXXXXGOAXXXXXXXXXXXXXXXXXXXGXXXXXXXXXXXXXXXXXXXXXGOOAAOOXXXXXXXXXXXXXXX,0,430,170
20958,38,8,30,162,231,0,0,430,336,94,GXXXXXXXXXXXXXXXXXXXXXGXXXXXXXXXXXXXXXXXXXXXGOXXXXXXXXXXXXXXXXXXXXGOAXXXXXXXXXXXXXXXXXXXGOOAAXXXXXXXXXXXXXXXXXGOOOOOAXXXXXXXXXXXXXXXGXAXXXXXXXXXXXXXXXXXXXGOXXXXXXXXXXXXXXXXXXXXGOXXXXXXXXXXXXXXXXXXXXGOXXXXXXXXXXXXXXXXXXXXGOAXXXXXXXXXXXXXXXXXXXGXXXXXXXXXXXXXXXXXXXXXGOOAAOOXXXXXXXXXXXXXXX,0,430,170
20979,39,9,30,158,234,0,0,433,340,93,GXXXXXXXXXXXXXXXXXXXXXGXXXXXXXXXXXXXXXXXXXXXGOXXXXXXXXXXXXXXXXXXXXGOAXXXXXXXXXXXXXXXXXXXGOOAAXXXXXXXXXXXXXXXXXGOOOOOAAXXXXXXXXXXXXXXGXAXXXXXXXXXXXXXXXXXXXGOXXXXXXXXXXXXXXXXXXXXGOXXXXXXXXXXXXXXXXXXXXGOXXXXXXXXXXXXXXXXXXXXGOAXXXXXXXXXXXXXXXXXXXGXXXXXXXXXXXXXXXXXXXXXGOOAAOOXXXXXXXXXXXXXXX,0,430,170

21000,38,9,29,161,231,0,0,430,341,89,GXXXXXXXXXXXXXXXXXXXXXGXXXXXXXXXXXXXXXXXXXXXGOXXXXXXXXXXXXXXXXXXXXGOAXXXXXXXXXXXXXXXXXXXGOOAAXXXXXXXXXXXXXXXXXGOOOOOAAXXXXXXXXXXXXXXGXAXXXXXXXXXXXXXXXXXXXGOXXXXXXXXXXXXXXXXXXXXGOXXXXXXXXXXXXXXXXXXXXGOXXXXXXXXXXXXXXXXXXXXGOAXXXXXXXXXXXXXXXXXXXGXXXXXXXXXXXXXXXXXXXXXGOOAAXOXXXXXXXXXXXXXXX,0,429,171
21021,37,8,29,163,230,0,0,429,334,95,GXXXXXXXXXXXXXXXXXXXXXGXXXXXXXXXXXXXXXXXXXXXGOXXXXXXXXXXXXXXXXXXXXGOAXXXXXXXXXXXXXXXXXXXGOOAAXXXXXXXXXXXXXXXXXGOOOOOAAXXXXXXXXXXXXXXGXOXXXXXXXXXXXXXXXXXXXGOXXXXXXXXXXXXXXXXXXXXGOXXXXXXXXXXXXXXXXXXXXGOXXXXXXXXXXXXXXXXXXXXGOAXXXXXXXXXXXXXXXXXXXGXXXXXXXXXXXXXXXXXXXXXGOOAAXXXXXXXXXXXXXXXXX,0,429,171
21042,37,7,30,164,229,0,0,429,335,94,GXXXXXXXXXXXXXXXXXXXXXGXXXXXXXXXXXXXXXXXXXXXGOXXXXXXXXXXXXXXXXXXXXGOAXXXXXXXXXXXXXXXXXXXGOOOAXXXXXXXXXXXXXXXXXGOOOOOAAXXXXXXXXXXXXXXGXOXXXXXXXXXXXXXXXXXXXGOXXXXXXXXXXXXXXXXXXXXGOXXXXXXXXXXXXXXXXXXXXGOXXXXXXXXXXXXXXXXXXXXGOAXXXXXXXXXXXXXXXXXXXGXXXXXXXXXXXXXXXXXXXXXGOOAAXXXXXXXXXXXXXXXXX,0,429,171
21063,37,7,30,160,233,0,0,433,336,97,GXXXXXXXXXXXXXXXXXXXXXGXXXXXXXXXXXXXXXXXXXXXGOXXXXXXXXXXXXXXXXXXXXGOAXXXXXXXXXXXXXXXXXXXGOOOAXXXXXXXXXXXXXXXXXGOOOOOAAXXXXXXXXXXXXXXGXOXXXXXXXXXXXXXXXXXXXGOXXXXXXXXXXXXXXXXXXXXGOXXXXXXXXXXXXXXXXXXXXGOXXXXXXXXXXXXXXXXXXXXGOAXXXXXXXXXXXXXXXXXXXGXXXXXXXXXXXXXXXXXXXXXGOOAAXXXXXXXXXXXXXXXXX,0,429,171
21084,37,7,30,165,228,0,0,428,334,94,GXXXXXXXXXXXXXXXXXXXXXGXXXXXXXXXXXXXXXXXXXXXGOXXXXXXXXXXXXXXXXXXXXGOAXXXXXXXXXXXXXXXXXXXGOOOAXXXXXXXXXXXXXXXXXGOOOOOAAXXXXXXXXXXXXXXGXOXXXXXXXXXXXXXXXXXXXGOXXXXXXXXXXXXXXXXXXXXGOXXXXXXXXXXXXXXXXXXXXGOXXXXXXXXXXXXXXXXXXXXGOAXXXXXXXXXXXXXXXXXXXGXXXXXXXXXXXXXXXXXXXXXGOOAAXXXXXXXXXXXXXXXXX,0,429,171

21105,37,7,30,169,224,0,0,424,330,94,GXXXXXXXXXXXXXXXXXXXXXGXXXXXXXXXXXXXXXXXXXXXGOXXXXXXXXXXXXXXXXXXXXGOAXXXXXXXXXXXXXXXXXXXGOOOAXXXXXXXXXXXXXXXXXGOOOOOAAXXXXXXXXXXXXXXGXOXXXXXXXXXXXXXXXXXXXGOXXXXXXXXXXXXXXXXXXXXGOXXXXXXXXXXXXXXXXXXXXGOXXXXXXXXXXXXXXXXXXXXGOAXXXXXXXXXXXXXXXXXXXGXXXXXXXXXXXXXXXXXXXXXGOOAAXXXXXXXXXXXXXXXXX,0,429,171
21126,37,7,30,171,222,0,0,422,330,92,GXXXXXXXXXXXXXXXXXXXXXGXXXXXXXXXXXXXXXXXXXXXGOXXXXXXXXXXXXXXXXXXXXGOAXXXXXXXXXXXXXXXXXXXGOOOAXXXXXXXXXXXXXXXXXGOOOOOAAXXXXXXXXXXXXXXGXOXXXXXXXXXXXXXXXXXXXGOXXXXXXXXXXXXXXXXXXXXGOXXXXXXXXXXXXXXXXXXXXGOXXXXXXXXXXXXXXXXXXXXGOAXXXXXXXXXXXXXXXXXXXGXXXXXXXXXXXXXXXXXXXXXGOOAAXXXXXXXXXXXXXXXXX,0,429,171
21147,38,7,31,176,216,0,0,416,326,90,GXXXXXXXXXXXXXXXXXXXXXGXXXXXXXXXXXXXXXXXXXXXGOXXXXXXXXXXXXXXXXXXXXGOAXXXXXXXXXXXXXXXXXXXGOOOAXXXXXXXXXXXXXXXXXGOOOOOOAAXXXXXXXXXXXXXGXOXXXXXXXXXXXXXXXXXXXGOXXXXXXXXXXXXXXXXXXXXGOXXXXXXXXXXXXXXXXXXXXGOXXXXXXXXXXXXXXXXXXXXGOAXXXXXXXXXXXXXXXXXXXGXXXXXXXXXXXXXXXXXXXXXGOOAAXXXXXXXXXXXXXXXXX,0,429,171
21168,38,6,32,175,217,0,0,419,328,91,GXXXXXXXXXXXXXXXXXXXXXGXXXXXXXXXXXXXXXXXXXXXGOXXXXXXXXXXXXXXXXXXXXGOAXXXXXXXXXXXXXXXXXXXGOOOOXXXXXXXXXXXXXXXXXGOOOOOOAAXXXXXXXXXXXXXGXOXXXXXXXXXXXXXXXXXXXGOXXXXXXXXXXXXXXXXXXXXGOXXXXXXXXXXXXXXXXXXXXGOXXXXXXXXXXXXXXXXXXXXGOAXXXXXXXXXXXXXXXXXXXGXXXXXXXXXXXXXXXXXXXXXGOOAAXXXXXXXXXXXXXXXXX,0,429,171
21189,38,6,32,172,220,0,0,422,328,94,GXXXXXXXXXXXXXXXXXXXXXGXXXXXXXXXXXXXXXXXXXXXGOXXXXXXXXXXXXXXXXXXXXGOAXXXXXXXXXXXXXXXXXXXGOOOOXXXXXXXXXXXXXXXXXGOOOOOOAAXXXXXXXXXXXXXGXOXXXXXXXXXXXXXXXXXXXGOXXXXXXXXXXXXXXXXXXXXGOXXXXXXXXXXXXXXXXXXXXGOXXXXXXXXXXXXXXXXXXXXGOAXXXXXXXXXXXXXXXXXXXGXXXXXXXXXXXXXXXXXXXXXGOOAAXXXXXXXXXXXXXXXXX,0,429,171

21210,39,7,32,170,221,0,0,423,330,93,GXXXXXXXXXXXXXXXXXXXXXGXXXXXXXXXXXXXXXXXXXXXGOXXXXXXXXXXXXXXXXXXXXGOAXXXXXXXXXXXXXXXXXXXGOOOOXXXXXXXXXXXXXXXXXGOOOOOOAAAXXXXXXXXXXXXGXOXXXXXXXXXXXXXXXXXXXGOXXXXXXXXXXXXXXXXXXXXGOXXXXXXXXXXXXXXXXXXXXGOXXXXXXXXXXXXXXXXXXXXGOAXXXXXXXXXXXXXXXXXXXGXXXXXXXXXXXXXXXXXXXXXGOOAAXXXXXXXXXXXXXXXXX,0,429,171
21231,39,7,32,170,221,0,0,423,331,92,GXXXXXXXXXXXXXXXXXXXXXGXXXXXXXXXXXXXXXXXXXXXGOXXXXXXXXXXXXXXXXXXXXGOAXXXXXXXXXXXXXXXXXXXGOOOOXXXXXXXXXXXXXXXXXGOOOOOOAAAXXXXXXXXXXXXGXOXXXXXXXXXXXXXXXXXXXGOXXXXXXXXXXXXXXXXXXXXGOXXXXXXXXXXXXXXXXXXXXGOXXXXXXXXXXXXXXXXXXXXGOAXXXXXXXXXXXXXXXXXXXGXXXXXXXXXXXXXXXXXXXXXGOOAAXXXXXXXXXXXXXXXXX,0,429,171
21252,38,7,31,166,225,0,0,424,334,90,GXXXXXXXXXXXXXXXXXXXXXGXXXXXXXXXXXXXXXXXXXXXGOXXXXXXXXXXXXXXXXXXXXGOAXXXXXXXXXXXXXXXXXXXGOOOOXXXXXXXXXXXXXXXXXGOOOOOXAAAXXXXXXXXXXXXGXOXXXXXXXXXXXXXXXXXXXGOXXXXXXXXXXXXXXXXXXXXGOXXXXXXXXXXXXXXXXXXXXGOXXXXXXXXXXXXXXXXXXXXGOAXXXXXXXXXXXXXXXXXXXGXXXXXXXXXXXXXXXXXXXXXGOOAAXXXXXXXXXXXXXXXXX,0,428,172
21273,35,3,32,167,227,0,0,430,338,92,GXXXXXXXXXXXXXXXXXXXXXGXXXXXXXXXXXXXXXXXXXXXGOXXXXXXXXXXXXXXXXXXXXGOAXXXXXXXXXXXXXXXXXXXGOOOOXXXXXXXXXXXXXXXXXGOOOOOXXXXXXXXXXXXXXXXGXOXXXXXXXXXXXXXXXXXXXGOXXXXXXXXXXXXXXXXXXXXGOXXXXXXXXXXXXXXXXXXXXGOXXXXXXXXXXXXXXXXXXXXGOOXXXXXXXXXXXXXXXXXXXGXXXXXXXXXXXXXXXXXXXXXGOOAAXXXXXXXXXXXXXXXXX,0,428,172
21294,35,3,32,163,231,0,0,434,347,87,GXXXXXXXXXXXXXXXXXXXXXGXXXXXXXXXXXXXXXXXXXXXGOXXXXXXXXXXXXXXXXXXXXGOAXXXXXXXXXXXXXXXXXXXGOOOOXXXXXXXXXXXXXXXXXGOOOOOXXXXXXXXXXXXXXXXGXOXXXXXXXXXXXXXXXXXXXGOXXXXXXXXXXXXXXXXXXXXGOXXXXXXXXXXXXXXXXXXXXGOXXXXXXXXXXXXXXXXXXXXGOOXXXXXXXXXXXXXXXXXXXGXXXXXXXXXXXXXXXXXXXXXGOOAAXXXXXXXXXXXXXXXXX,0,428,172

21315,36,4,32,168,225,0,0,428,347,81,GXXXXXXXXXXXXXXXXXXXXXGXXXXXXXXXXXXXXXXXXXXXGOXXXXXXXXXXXXXXXXXXXXGOAXXXXXXXXXXXXXXXXXXXGOOOOXXXXXXXXXXXXXXXXXGOOOOOXXXXXXXXXXXXXXXXGXOAXXXXXXXXXXXXXXXXXXGOXXXXXXXXXXXXXXXXXXXXGOXXXXXXXXXXXXXXXXXXXXGOXXXXXXXXXXXXXXXXXXXXGOOXXXXXXXXXXXXXXXXXXXGXXXXXXXXXXXXXXXXXXXXXGOOAAXXXXXXXXXXXXXXXXX,0,428,172
21336,36,4,32,169,224,0,0,427,345,82,GXXXXXXXXXXXXXXXXXXXXXGXXXXXXXXXXXXXXXXXXXXXGOXXXXXXXXXXXXXXXXXXXXGOAXXXXXXXXXXXXXXXXXXXGOOOOXXXXXXXXXXXXXXXXXGOOOOOXXXXXXXXXXXXXXXXGXOAXXXXXXXXXXXXXXXXXXGOXXXXXXXXXXXXXXXXXXXXGOXXXXXXXXXXXXXXXXXXXXGOXXXXXXXXXXXXXXXXXXXXGOOXXXXXXXXXXXXXXXXXXXGXXXXXXXXXXXXXXXXXXXXXGOOAAXXXXXXXXXXXXXXXXX,0,428,172
21357,37,5,32,164,228,0,0,431,345,86,GXXXXXXXXXXXXXXXXXXXXXGXXXXXXXXXXXXXXXXXXXXXGOXXXXXXXXXXXXXXXXXXXXGOAXXXXXXXXXXXXXXXXXXXGOOOOXXXXXXXXXXXXXXXXXGOOOOOXXXXXXXXXXXXXXXXGXOAXXXXXXXXXXXXXXXXXXGOXXXXXXXXXXXXXXXXXXXXGOXXXXXXXXXXXXXXXXXXXXGOXXXXXXXXXXXXXXXXXXXXGOOXXXXXXXXXXXXXXXXXXXGXXXXXXXXXXXXXXXXXXXXXGOOAAAXXXXXXXXXXXXXXXX,0,428,172
21378,37,5,32,164,228,0,0,431,350,81,GXXXXXXXXXXXXXXXXXXXXXGXXXXXXXXXXXXXXXXXXXXXGOXXXXXXXXXXXXXXXXXXXXGOAXXXXXXXXXXXXXXXXXXXGOOOOXXXXXXXXXXXXXXXXXGOOOOOXXXXXXXXXXXXXXXXGXOAXXXXXXXXXXXXXXXXXXGOXXXXXXXXXXXXXXXXXXXXGOXXXXXXXXXXXXXXXXXXXXGOXXXXXXXXXXXXXXXXXXXXGOOXXXXXXXXXXXXXXXXXXXGXXXXXXXXXXXXXXXXXXXXXGOOAAAXXXXXXXXXXXXXXXX,0,428,172
21399,37,5,32,168,224,0,0,427,347,80,GXXXXXXXXXXXXXXXXXXXXXGXXXXXXXXXXXXXXXXXXXXXGOXXXXXXXXXXXXXXXXXXXXGOAXXXXXXXXXXXXXXXXXXXGOOOOXXXXXXXXXXXXXXXXXGOOOOOXXXXXXXXXXXXXXXXGXOAXXXXXXXXXXXXXXXXXXGOXXXXXXXXXXXXXXXXXXXXGOXXXXXXXXXXXXXXXXXXXXGOXXXXXXXXXXXXXXXXXXXXGOOXXXXXXXXXXXXXXXXXXXGXXXXXXXXXXXXXXXXXXXXXGOOAAAXXXXXXXXXXXXXXXX,0,428,172

21420,37,6,31,167,224,0,0,427,341,86,GXXXXXXXXXXXXXXXXXXXXXGXXXXXXXXXXXXXXXXXXXXXGOXXXXXXXXXXXXXXXXXXXXGOAXXXXXXXXXXXXXXXXXXXGOOOOXXXXXXXXXXXXXXXXXGOOOOOAXXXXXXXXXXXXXXXGXOAXXXXXXXXXXXXXXXXXXGOXXXXXXXXXXXXXXXXXXXXGOXXXXXXXXXXXXXXXXXXXXGXXXXXXXXXXXXXXXXXXXXXGOOXXXXXXXXXXXXXXXXXXXGXXXXXXXXXXXXXXXXXXXXXGOOAAAXXXXXXXXXXXXXXXX,0,427,173
21441,37,6,31,169,222,0,0,425,342,83,GXXXXXXXXXXXXXXXXXXXXXGXXXXXXXXXXXXXXXXXXXXXGOXXXXXXXXXXXXXXXXXXXXGOAXXXXXXXXXXXXXXXXXXXGOOOOXXXXXXXXXXXXXXXXXGOOOOOAXXXXXXXXXXXXXXXGXOAXXXXXXXXXXXXXXXXXXGOXXXXXXXXXXXXXXXXXXXXGOXXXXXXXXXXXXXXXXXXXXGXXXXXXXXXXXXXXXXXXXXXGOOXXXXXXXXXXXXXXXXXXXGXXXXXXXXXXXXXXXXXXXXXGOOAAAXXXXXXXXXXXXXXXX,0,427,173
21462,36,6,30,171,220,0,0,423,338,85,GXXXXXXXXXXXXXXXXXXXXXGXXXXXXXXXXXXXXXXXXXXXGOXXXXXXXXXXXXXXXXXXXXGOAXXXXXXXXXXXXXXXXXXXGOOOOXXXXXXXXXXXXXXXXXGOOOOOAXXXXXXXXXXXXXXXGXOAXXXXXXXXXXXXXXXXXXGOXXXXXXXXXXXXXXXXXXXXGOXXXXXXXXXXXXXXXXXXXXGXXXXXXXXXXXXXXXXXXXXXGOXXXXXXXXXXXXXXXXXXXXGXXXXXXXXXXXXXXXXXXXXXGOOAAAXXXXXXXXXXXXXXXX,0,426,174
21483,36,6,30,166,225,0,0,427,341,86,GXXXXXXXXXXXXXXXXXXXXXGXXXXXXXXXXXXXXXXXXXXXGOXXXXXXXXXXXXXXXXXXXXGOAXXXXXXXXXXXXXXXXXXXGOOOOXXXXXXXXXXXXXXXXXGOOOOOAXXXXXXXXXXXXXXXGXOAXXXXXXXXXXXXXXXXXXGOXXXXXXXXXXXXXXXXXXXXGOXXXXXXXXXXXXXXXXXXXXGXXXXXXXXXXXXXXXXXXXXXGOXXXXXXXXXXXXXXXXXXXXGXXXXXXXXXXXXXXXXXXXXXGOOAAAXXXXXXXXXXXXXXXX,0,426,174
21504,36,5,31,168,223,0,0,426,340,86,GXXXXXXXXXXXXXXXXXXXXXGXXXXXXXXXXXXXXXXXXXXXGOXXXXXXXXXXXXXXXXXXXXGOAXXXXXXXXXXXXXXXXXXXGOOOOXXXXXXXXXXXXXXXXXGOOOOOAXXXXXXXXXXXXXXXGXOAXXXXXXXXXXXXXXXXXXGOXXXXXXXXXXXXXXXXXXXXGOXXXXXXXXXXXXXXXXXXXXGXXXXXXXXXXXXXXXXXXXXXGOXXXXXXXXXXXXXXXXXXXXGXXXXXXXXXXXXXXXXXXXXXGOOAAOXXXXXXXXXXXXXXXX,0,426,174

21525,36,5,31,170,221,0,0,425,343,82,GXXXXXXXXXXXXXXXXXXXXXGXXXXXXXXXXXXXXXXXXXXXGOXXXXXXXXXXXXXXXXXXXXGOAXXXXXXXXXXXXXXXXXXXGOOOOXXXXXXXXXXXXXXXXXGOOOOOAXXXXXXXXXXXXXXXGXOAXXXXXXXXXXXXXXXXXXGOXXXXXXXXXXXXXXXXXXXXGOXXXXXXXXXXXXXXXXXXXXGXXXXXXXXXXXXXXXXXXXXXGOXXXXXXXXXXXXXXXXXXXXGXXXXXXXXXXXXXXXXXXXXXGOOAAOXXXXXXXXXXXXXXXX,0,426,174
21546,36,5,31,175,216,0,0,420,343,77,GXXXXXXXXXXXXXXXXXXXXXGXXXXXXXXXXXXXXXXXXXXXGOXXXXXXXXXXXXXXXXXXXXGOAXXXXXXXXXXXXXXXXXXXGOOOOXXXXXXXXXXXXXXXXXGOOOOOAXXXXXXXXXXXXXXXGXOAXXXXXXXXXXXXXXXXXXGOXXXXXXXXXXXXXXXXXXXXGOXXXXXXXXXXXXXXXXXXXXGXXXXXXXXXXXXXXXXXXXXXGOXXXXXXXXXXXXXXXXXXXXGXXXXXXXXXXXXXXXXXXXXXGOOAAOXXXXXXXXXXXXXXXX,0,426,174
21567,36,7,29,174,215,0,0,418,347,71,GAXXXXXXXXXXXXXXXXXXXXGXXXXXXXXXXXXXXXXXXXXXGXXXXXXXXXXXXXXXXXXXXXGOAXXXXXXXXXXXXXXXXXXXGOOOOXXXXXXXXXXXXXXXXXGOXOOOAXXXXXXXXXXXXXXXGXOAXXXXXXXXXXXXXXXXXXGOXXXXXXXXXXXXXXXXXXXXGOXXXXXXXXXXXXXXXXXXXXGXXXXXXXXXXXXXXXXXXXXXGOAXXXXXXXXXXXXXXXXXXXGXXXXXXXXXXXXXXXXXXXXXGOOAAOXXXXXXXXXXXXXXXX,0,424,176
21588,36,6,30,178,211,0,0,416,341,75,GAXXXXXXXXXXXXXXXXXXXXGXXXXXXXXXXXXXXXXXXXXXGXXXXXXXXXXXXXXXXXXXXXGOAXXXXXXXXXXXXXXXXXXXGOOOOXXXXXXXXXXXXXXXXXGOXOOOAXXXXXXXXXXXXXXXGXOOXXXXXXXXXXXXXXXXXXGOXXXXXXXXXXXXXXXXXXXXGOXXXXXXXXXXXXXXXXXXXXGXXXXXXXXXXXXXXXXXXXXXGOAXXXXXXXXXXXXXXXXXXXGXXXXXXXXXXXXXXXXXXXXXGOOAAOXXXXXXXXXXXXXXXX,0,424,176
21609,36,6,30,172,217,0,0,422,344,78,GAXXXXXXXXXXXXXXXXXXXXGXXXXXXXXXXXXXXXXXXXXXGXXXXXXXXXXXXXXXXXXXXXGOAXXXXXXXXXXXXXXXXXXXGOOOOXXXXXXXXXXXXXXXXXGOXOOOAXXXXXXXXXXXXXXXGXOOXXXXXXXXXXXXXXXXXXGOXXXXXXXXXXXXXXXXXXXXGOXXXXXXXXXXXXXXXXXXXXGXXXXXXXXXXXXXXXXXXXXXGOAXXXXXXXXXXXXXXXXXXXGXXXXXXXXXXXXXXXXXXXXXGOOAAOXXXXXXXXXXXXXXXX,0,424,176

21630,35,5,30,172,217,0,0,423,344,79,GOXXXXXXXXXXXXXXXXXXXXGXXXXXXXXXXXXXXXXXXXXXGXXXXXXXXXXXXXXXXXXXXXGOAXXXXXXXXXXXXXXXXXXXGOOOOXXXXXXXXXXXXXXXXXGXXOOOAXXXXXXXXXXXXXXXGXOOXXXXXXXXXXXXXXXXXXGOXXXXXXXXXXXXXXXXXXXXGOXXXXXXXXXXXXXXXXXXXXGXXXXXXXXXXXXXXXXXXXXXGOAXXXXXXXXXXXXXXXXXXXGXXXXXXXXXXXXXXXXXXXXXGOOAAOXXXXXXXXXXXXXXXX,0,423,177
21651,35,4,31,176,213,0,0,420,342,78,GOXXXXXXXXXXXXXXXXXXXXGXXXXXXXXXXXXXXXXXXXXXGXXXXXXXXXXXXXXXXXXXXXGOAXXXXXXXXXXXXXXXXXXXGOOOOXXXXXXXXXXXXXXXXXGXXOOOAXXXXXXXXXXXXXXXGXOOXXXXXXXXXXXXXXXXXXGOXXXXXXXXXXXXXXXXXXXXGOXXXXXXXXXXXXXXXXXXXXGXXXXXXXXXXXXXXXXXXXXXGOAXXXXXXXXXXXXXXXXXXXGXXXXXXXXXXXXXXXXXXXXXGOOAOOXXXXXXXXXXXXXXXX,0,423,177
21672,35,4,31,177,212,0,0,419,342,77,GOXXXXXXXXXXXXXXXXXXXXGXXXXXXXXXXXXXXXXXXXXXGXXXXXXXXXXXXXXXXXXXXXGOAXXXXXXXXXXXXXXXXXXXGOOOOXXXXXXXXXXXXXXXXXGXXOOOAXXXXXXXXXXXXXXXGXOOXXXXXXXXXXXXXXXXXXGOXXXXXXXXXXXXXXXXXXXXGOXXXXXXXXXXXXXXXXXXXXGXXXXXXXXXXXXXXXXXXXXXGOAXXXXXXXXXXXXXXXXXXXGXXXXXXXXXXXXXXXXXXXXXGOOAOOXXXXXXXXXXXXXXXX,0,423,177
21693,37,6,31,171,216,0,0,423,341,82,GOXXXXXXXXXXXXXXXXXXXXGXXXXXXXXXXXXXXXXXXXXXGXXXXXXXXXXXXXXXXXXXXXGOAXXXXXXXXXXXXXXXXXXXGOOOOXXXXXXXXXXXXXXXXXGXXOOOAAXXXXXXXXXXXXXXGAOOXXXXXXXXXXXXXXXXXXGOXXXXXXXXXXXXXXXXXXXXGOXXXXXXXXXXXXXXXXXXXXGXXXXXXXXXXXXXXXXXXXXXGOAXXXXXXXXXXXXXXXXXXXGXXXXXXXXXXXXXXXXXXXXXGOOAOOXXXXXXXXXXXXXXXX,0,423,177
21714,36,6,30,171,216,0,0,423,344,79,GOXXXXXXXXXXXXXXXXXXXXGXXXXXXXXXXXXXXXXXXXXXGXXXXXXXXXXXXXXXXXXXXXGOAXXXXXXXXXXXXXXXXXXXGOOOOXXXXXXXXXXXXXXXXXGXXOOOAAXXXXXXXXXXXXXXGAOOXXXXXXXXXXXXXXXXXXGOXXXXXXXXXXXXXXXXXXXXGXXXXXXXXXXXXXXXXXXXXXGXXXXXXXXXXXXXXXXXXXXXGOAXXXXXXXXXXXXXXXXXXXGXXXXXXXXXXXXXXXXXXXXXGOOAOOXXXXXXXXXXXXXXXX,0,422,178

21735,36,6,30,173,214,0,0,421,341,80,GOXXXXXXXXXXXXXXXXXXXXGXXXXXXXXXXXXXXXXXXXXXGXXXXXXXXXXXXXXXXXXXXXGOAXXXXXXXXXXXXXXXXXXXGOOOOXXXXXXXXXXXXXXXXXGXXOOOAAXXXXXXXXXXXXXXGAOOXXXXXXXXXXXXXXXXXXGOXXXXXXXXXXXXXXXXXXXXGXXXXXXXXXXXXXXXXXXXXXGXXXXXXXXXXXXXXXXXXXXXGOAXXXXXXXXXXXXXXXXXXXGXXXXXXXXXXXXXXXXXXXXXGOOAOOXXXXXXXXXXXXXXXX,0,422,178
21756,36,6,30,176,211,0,0,418,339,79,GOXXXXXXXXXXXXXXXXXXXXGXXXXXXXXXXXXXXXXXXXXXGXXXXXXXXXXXXXXXXXXXXXGOAXXXXXXXXXXXXXXXXXXXGOOOOXXXXXXXXXXXXXXXXXGXXOOOAAXXXXXXXXXXXXXXGAOOXXXXXXXXXXXXXXXXXXGOXXXXXXXXXXXXXXXXXXXXGXXXXXXXXXXXXXXXXXXXXXGXXXXXXXXXXXXXXXXXXXXXGOAXXXXXXXXXXXXXXXXXXXGXXXXXXXXXXXXXXXXXXXXXGOOAOOXXXXXXXXXXXXXXXX,0,422,178
21777,37,7,30,173,213,0,0,420,342,78,GOXXXXXXXXXXXXXXXXXXXXGXXXXXXXXXXXXXXXXXXXXXGXXXXXXXXXXXXXXXXXXXXXGOAXXXXXXXXXXXXXXXXXXXGOOOOXXXXXXXXXXXXXXXXXGXXOOOAAAXXXXXXXXXXXXXGAOOXXXXXXXXXXXXXXXXXXGOXXXXXXXXXXXXXXXXXXXXGXXXXXXXXXXXXXXXXXXXXXGXXXXXXXXXXXXXXXXXXXXXGOAXXXXXXXXXXXXXXXXXXXGXXXXXXXXXXXXXXXXXXXXXGOOAOOXXXXXXXXXXXXXXXX,0,422,178
21798,36,7,29,173,213,0,0,420,343,77,GOXXXXXXXXXXXXXXXXXXXXGXXXXXXXXXXXXXXXXXXXXXGXXXXXXXXXXXXXXXXXXXXXGOAXXXXXXXXXXXXXXXXXXXGOOOOXXXXXXXXXXXXXXXXXGXXOOOAAAXXXXXXXXXXXXXGAXOXXXXXXXXXXXXXXXXXXGOXXXXXXXXXXXXXXXXXXXXGXXXXXXXXXXXXXXXXXXXXXGXXXXXXXXXXXXXXXXXXXXXGOAXXXXXXXXXXXXXXXXXXXGXXXXXXXXXXXXXXXXXXXXXGOOAOOXXXXXXXXXXXXXXXX,0,421,179
21819,37,8,29,172,213,0,0,421,343,78,GOXXXXXXXXXXXXXXXXXXXXGXXXXXXXXXXXXXXXXXXXXXGAXXXXXXXXXXXXXXXXXXXXGOAXXXXXXXXXXXXXXXXXXXGOOOOXXXXXXXXXXXXXXXXXGXXOOOAAAXXXXXXXXXXXXXGAXOXXXXXXXXXXXXXXXXXXGOXXXXXXXXXXXXXXXXXXXXGXXXXXXXXXXXXXXXXXXXXXGXXXXXXXXXXXXXXXXXXXXXGOAXXXXXXXXXXXXXXXXXXXGXXXXXXXXXXXXXXXXXXXXXGOOAOOXXXXXXXXXXXXXXXX,0,421,179

